aacagctgaattagcacg	cluster_8
acaaggtgagacagatgt	cluster_4
acccaatgctaaggattg	cluster_1
acggactgttcgaggtta	cluster_8
atagcggcgcgggaggcc	cluster_6
atataccggtccccgatg	cluster_1
atgaagccacgcaagtat	cluster_8
caaccggctgaggagtga	cluster_8
caccactgaattccgatg	cluster_1
cggcgtgagcttagcacg	cluster_8
cggtccgaggcctgagac	cluster_1
ctattataatagatatac	cluster_9
ctcaatacccaatagagg	cluster_1
ctgtggttgctcccacgc	cluster_1
cttacggcttgtgctgag	cluster_10
gaaatactattagtggtg	cluster_8
gagctttgaattctcaat	cluster_8
gaggccagacccgcttgt	cluster_1
gatcaaatccggatagcg	cluster_1
gccgttagtctgatatac	cluster_1
gccgttcaaccggactcg	cluster_1
gcgaatgagcttgtggtg	cluster_6
gctgagcgaaagatactt	cluster_8
gctgaggggatccataga	cluster_8
ggacgacggcgtttaaga	cluster_1
ggattgttcttgtcggga	cluster_8
gggatcaattggttgctc	cluster_10
gggatctgcggtttggat	cluster_11
gtacagagtaaagagctt	cluster_10
gtcctacttacgatatac	cluster_1
gtcggcgaaatacgttat	cluster_8
gtggtggctgagttaaga	cluster_10
gttaacaagccaagtctg	cluster_6
gttaacgatcaaaattgg	cluster_11
taatagacaaggtccaag	cluster_10
tccaagatacttcaggag	cluster_10
tcgcctaacgtgctcaat	cluster_1
tcgcctcggcgtcgttat	cluster_8
tcgcctgctcccctatta	cluster_8
tgagacgtcctaagcacg	cluster_10
tggcagcgcataagtctg	cluster_1
tgtgtagctcccctatta	cluster_1
ttcgcaaaagaaattagt	cluster_8
ttggatgagtgaagatgt	cluster_1
gagtgaccgatgtctagc	cluster_1
gcttgtctattaatccgg	cluster_9
aacgtgtctagcgtacag	cluster_1
cggcgttgtgtactgtgg	cluster_9
gactcgtccaagcagact	cluster_1
gagtgagcgcggtagagg	cluster_1
tgagacgactcgatactt	cluster_9
atatactgcggtgttaac	cluster_9
gactcgattagtagaccc	cluster_1
taagctagtaaatcggga	cluster_1
cagactgttaacatccgg	cluster_9
tatttcacccaagatcaa	cluster_1
acaaggggtgctcggcgt	cluster_1
tgagacccacgctagagg	cluster_1
tgagaccagactctgtgg	cluster_1
cttgaaacccaattgctc	cluster_9
ccgtaatccaagcaggag	cluster_1
cctctatgaattgtccta	cluster_1
gcgaatgcgaatcgcata	cluster_1
tagaggttcgcatgcggt	cluster_1
ggtgctgagtgagaggcc	cluster_9
cactgtaattgggagctt	cluster_2
ggtaggaattggggacga	cluster_9
cggcgtaagccattcgca	cluster_1
tcagtggccgttaacgtg	cluster_1
gtacagaaagaaactgca	cluster_1
gtcggctaatagatactt	cluster_1
ttcttgagatgtatccgg	cluster_9
tgagacatccggttggat	cluster_1
gaggcctggcaggggatc	cluster_1
atatactctagcgtggtg	cluster_9
tctagctgagacgaggcc	cluster_1
tgagacgatcaaacaagg	cluster_4
ttcttgtgaattagtaaa	cluster_2
agtctgttcgcagggatc	cluster_4
gtttcatggcagcgttat	cluster_1
cggtccgatcaacgagca	cluster_1
caggagacggactagagg	cluster_1
ctgtggaggttatccaag	cluster_1
ccgatgggacgaaacgtg	cluster_4
atccggttgctctcggga	cluster_1
gccagagtcggcgccgtt	cluster_1
atccggttcgcaccacgc	cluster_1
aagtatagatgtgggatc	cluster_9
ccacgcgcgcgggctgag	cluster_1
agcacgtaataggtacag	cluster_1
cgttatctattaaagcca	cluster_1
ctgtggttaagaacaagg	cluster_1
ttggatgcgaatatactt	cluster_1
aagccattgctcgtttca	cluster_4
cttgaactaggtcttgaa	cluster_1
ttcgcatgtgtaaagcca	cluster_1
agcacgcggtccgctccc	cluster_4
agatgtaattggaacagc	cluster_1
agatgttaccgagctgag	cluster_1
gggatcttcgcagctccc	cluster_1
tttgggctattataagct	cluster_1
gatcaatgttcgcgttat	cluster_1
ttcgcaagcacgcaccac	cluster_1
caaccgtcgggaggacga	cluster_2
caagtcggtaggagcacg	cluster_4
tatttcacaaggttaaga	cluster_1
ctgtggaacagccaaccg	cluster_1
acaaggcatagattggat	cluster_1
ggacgaatagcgcggtcc	cluster_1
caccaccaagtccggtcc	cluster_1
cgcatagctcccgttaac	cluster_1
agcacggaagggcataga	cluster_2
atccggctattagcttgt	cluster_6
agcacgatccgggagctt	cluster_4
cactgtgtcctatctagc	cluster_1
gcgaataggttagtccta	cluster_1
tgctaataatagcaagtc	cluster_1
ctaggtgagtgagtttca	cluster_9
caccactagagggggatc	cluster_1
accttctgtgtagcgcgg	cluster_1
aacgtgcgttatgtcggc	cluster_1
tttgggttcgcatggcag	cluster_1
ttcgcatgcggtgatcaa	cluster_1
cttacgactgcactatta	cluster_1
tatttcaagtatagaccc	cluster_2
gctgaggcttgtgccgtt	cluster_2
gatcaaggattggctccc	cluster_2
tgttcgatatacactgca	cluster_1
tttggggcgaattcagtg	cluster_1
tcagtgtctagcttcgca	cluster_1
taccgagccgttgccaga	cluster_1
ggtgctgccgttcactgt	cluster_2
tgctaaattagtatagcg	cluster_1
gcgcggagcacgtagagg	cluster_1
catagacagacttaagct	cluster_1
tgaattaccttccgagca	cluster_2
cgaaagttcttgttcttg	cluster_2
tgagactggcagccacgc	cluster_2
cggcgtggattgttgctc	cluster_1
atgaaggttaactgagac	cluster_1
gctccctttgggattagt	cluster_1
agacccacaagggtccta	cluster_1
atagcgcttacgcgagca	cluster_1
tgagacgtacagacaagg	cluster_1
gaaataccgatgaggtta	cluster_2
tatttcacaagggtggtg	cluster_2
accttcgactcggcttgt	cluster_4
actgcagagtgacaagtc	cluster_6
gttaacgaaatatcatca	cluster_2
ttcgcaagtaaaccgtaa	cluster_2
ttgctcaagtatttcttg	cluster_1
aagccaatatacatccgg	cluster_1
tgtgtagggatcgtacag	cluster_1
aacgtgtcatcacaggag	cluster_1
cggtccgctcccgaaata	cluster_1
tcgccttaagctgagctt	cluster_1
aaagaagtcggcgcttgt	cluster_6
ttgctcaacgtggaaata	cluster_2
tctagccaggagtcgcct	cluster_1
ccacgccaaccggatcaa	cluster_1
cactgtccacgctaatag	cluster_1
aagtatgccagatctagc	cluster_1
ttcttgcgcataacccaa	cluster_1
tatttcgagctttaagct	cluster_2
ttcgcatcgcctcactgt	cluster_1
ttcgcatttgggctcaat	cluster_6
cggtccctgtgggggatc	cluster_2
tgaattaccttccactgt	cluster_1
cgagcatgctaaaccttc	cluster_1
aattggcaccacgttaac	cluster_6
tgctaacgttattaatag	cluster_1
cctctacaaccgcaagtc	cluster_2
aagccaaacgtgcggtcc	cluster_1
cctctaaggttataccga	cluster_1
gccgtttgttcggatcaa	cluster_2
ggtaggtcatcatgttcg	cluster_6
ccgtaaccacgcatatac	cluster_6
tcgggaggccatgccaga	cluster_1
gaggccgtggtgcggtcc	cluster_1
tagaggtggcagtgcggt	cluster_1
ttggatggtaggaggtta	cluster_2
tccaaggccgttcgaaag	cluster_1
tgctaaagtctgaccttc	cluster_1
tcatcagggatcgtcggc	cluster_2
cctctataagcttaagct	cluster_1
aacgtgtcatcaattagt	cluster_1
ggccattaagctatatac	cluster_1
taccgaaacgtgggtgct	cluster_1
catagaatccggggacga	cluster_1
catagatatttcacggac	cluster_1
gcgcggtgcggttgcggt	cluster_6
gaaataatactttccaag	cluster_1
acggacggtaggcttgaa	cluster_4
gccagagttaactagagg	cluster_1
agtctggatcaattcgca	cluster_1
cgttattgttcgaacgtg	cluster_1
gctgaggctgagtggcag	cluster_2
caagtcggtgctggtagg	cluster_1
cgaaagacaaggcagact	cluster_2
tctagccactgttgctaa	cluster_1
gcgcggtcagtggcgaat	cluster_1
cgaaaggtttcatgaatt	cluster_1
agatgtgctccctcatca	cluster_1
tcagtgtaagcttggcag	cluster_1
tgagacggattgaacagc	cluster_1
tttgggggacgacttacg	cluster_1
tgagactcagtgaaagaa	cluster_1
ctgtggtaccgatggcag	cluster_1
acaaggcctctataatag	cluster_1
acggaccgagcaatagcg	cluster_11
gagcttatccgggcttgt	cluster_1
tggcagcgagcacggcgt	cluster_1
actgcagttaaccaccac	cluster_1
cggcgtgtacagattagt	cluster_1
ggtaggctaggtccgtaa	cluster_9
gctgagactgcaagatgt	cluster_2
attagtatccggtatttc	cluster_1
atccggtggcagccacgc	cluster_1
gtacagacggacaaagaa	cluster_1
ggtaggggtgctcggcgt	cluster_1
tgagacgtcggctggcag	cluster_1
caagtctcgcctgaggcc	cluster_6
cactgtatataccaagtc	cluster_2
agtaaataccgaaagtat	cluster_2
tctagcatacttcggcgt	cluster_2
agtctgtggcaggggatc	cluster_4
ccacgcggattgaagtat	cluster_4
atatacggtgcttcgcct	cluster_1
gctgagtccaagtcgcct	cluster_1
acggaccgaaagagcacg	cluster_1
ttcttgagtctgaacgtg	cluster_1
ggccatacaaggggccat	cluster_1
aagccagagctttcggga	cluster_1
agatgtagatgtaacgtg	cluster_1
gccgttatactttggcag	cluster_1
aattggcaggaggccaga	cluster_1
tcagtgcgttatgggatc	cluster_4
gtacagggccattcggga	cluster_1
gggatctggcaggctccc	cluster_1
aacgtgaattggcgaaag	cluster_1
agcacggcttgtattagt	cluster_4
tgttcgcaggagtgtgta	cluster_1
cgcatatgaatttcggga	cluster_1
tccaagggacgagtcggc	cluster_1
gtggtggtggtgggattg	cluster_1
gctgagttaagaaacagc	cluster_1
cactgtaggttagtggtg	cluster_1
cgaaagtcgggacaaccg	cluster_1
attagtggacgaggccat	cluster_1
tatttcattagttaagct	cluster_1
agtctgcactgtcggcgt	cluster_1
atgaagtaccgaacggac	cluster_1
aagtataattggcctcta	cluster_1
acggactgctaaaagcca	cluster_1
acaaggagacccggtgct	cluster_1
acaaggtgtgtattggat	cluster_6
cctctatgaattgactcg	cluster_1
tttgggggattgaccttc	cluster_1
ggacgaggacgagccgtt	cluster_1
tgttcgtagaggcaccac	cluster_2
tttgggagcacgtagagg	cluster_1
agtctggatcaagtcggc	cluster_2
gactcggcttgtgcgaat	cluster_1
acccaataagctcgttat	cluster_1
agatgtctaggtgaggcc	cluster_6
agcacggtggtggcgaat	cluster_7
agtaaacgttattcggga	cluster_5
atgaagtagaggactgca	cluster_1
cactgtcctctagccgtt	cluster_7
ccacgcgctccctgttcg	cluster_5
cgaaagctattaagtaaa	cluster_5
cgttatatccggcagact	cluster_11
ctaggtgccgtttgctaa	cluster_6
ctattagcgaatgcgcgg	cluster_5
cttgaaccgatggtacag	cluster_6
gaaggggaggccgtcggc	cluster_5
gagtgagaaataggtagg	cluster_4
gcgaatcggcgtagatgt	cluster_1
ggattgtcatcaagtctg	cluster_4
gggatcactgcacgaaag	cluster_10
ggtgctatatacgcgcgg	cluster_1
ggtgcttccaagtggcag	cluster_6
gtcggcgttaaccttacg	cluster_4
gttaacaacagccgttat	cluster_4
gttaacgccagattcgca	cluster_5
taatagaattggccacgc	cluster_10
taccgattcgcacagact	cluster_4
tagaggatgaaggctgag	cluster_7
tcatcaatacttcttgaa	cluster_4
tcatcacggcgtgtggtg	cluster_7
tcgcctcatagacggtcc	cluster_5
tcgggagaagggccacgc	cluster_6
tctagcgtcggcgagctt	cluster_5
tgctaataccgacgcata	cluster_5
tgttcgctcaatacaagg	cluster_8
ttaagactaggtctatta	cluster_6
ttaagagcgaatttcgca	cluster_6
ttgctcaccttcttaaga	cluster_1
aattgggcgcgggccgtt	cluster_4
aattggtaatagcgagca	cluster_4
aattggtttgggattagt	cluster_6
acaaggtcagtgtaccga	cluster_4
acccaacagactcgagca	cluster_6
acggacgtacagtgagac	cluster_6
acggacttgctcggacga	cluster_1
agaccccgttatttggat	cluster_6
atagcgagcacggtcggc	cluster_4
atatacaacgtgtcatca	cluster_1
cagactttaagaattagt	cluster_11
ccgatggctgagtcagtg	cluster_5
cgaaagagcacgcgaaag	cluster_10
cgaaaggagtgaatagcg	cluster_11
cgaaagggccataacgtg	cluster_6
cggcgtgccgttcgagca	cluster_6
ctattacaccactcgcct	cluster_6
ctcaatgtcggctatttc	cluster_6
ctgtggccgatggcgaat	cluster_4
ctgtgggatcaactcaat	cluster_6
cttgaacgaaagactgca	cluster_4
cttgaataccgattgctc	cluster_4
gaggccgagtgacgcata	cluster_4
gagtgacttacgcactgt	cluster_4
gatcaaattagtaacagc	cluster_6
gccagacttacgagtaaa	cluster_6
gcgaatgagctttatttc	cluster_4
gcgcggtagaggattagt	cluster_6
gctcccatatacctgtgg	cluster_4
gctgaggaaatacataga	cluster_11
gctgagtgcggtacggac	cluster_4
gcttgtctgtggcaccac	cluster_11
ggacgaagtaaacctcta	cluster_4
ggacgacgagcataagct	cluster_4
ggccattcgccttggcag	cluster_6
ggtagggagcttcaaccg	cluster_1
ggtagggctgagacggac	cluster_6
ggtgctagtaaaagatgt	cluster_6
ggtgcttatttcccgatg	cluster_4
gtcggcaagtatattagt	cluster_6
gtcggccgcatattcttg	cluster_4
gtggtgctgtgggccaga	cluster_6
gttaactgagacggacga	cluster_6
taagctggccatccgtaa	cluster_6
taatagtgtgtaccgtaa	cluster_6
taccgacactgtatagcg	cluster_4
tagaggatacttcggcgt	cluster_6
tcagtgaattggtctagc	cluster_6
tcagtgttaagatttggg	cluster_11
tcatcactcaattagagg	cluster_4
tcgcctatagcgcgcata	cluster_4
tcgggaaagtatcggcgt	cluster_6
tgaattgtacagtgtgta	cluster_4
ttgctcagtaaaaacgtg	cluster_1
ttgctccaaccggttaac	cluster_6
ttgctccaggagtggcag	cluster_4
gcgcgggtcggctgcggt	cluster_8
aattgggaggcccgagca	cluster_8
cggcgtcgagcagccaga	cluster_8
agcacgggccattcggga	cluster_8
tcgcctcgagcacaccac	cluster_11
atacttcaggaggagctt	cluster_11
tttgggaacgtggagctt	cluster_8
gtggtgtcatcaggtagg	cluster_11
agcacgctattatcatca	cluster_10
catagaccgatggcgcgg	cluster_10
gcgaatgtcctaatccgg	cluster_10
gcgcggaagccaggccat	cluster_8
ccacgcaattggatatac	cluster_8
gactcgaaagaagatcaa	cluster_11
gtcggctcatcaggattg	cluster_8
ctgtgggaggccagtaaa	cluster_10
ccacgccaggagcctcta	cluster_10
cttgaaatagcgtcatca	cluster_8
ccacgcctaggtcgaaag	cluster_10
aaagaagtggtgaagcca	cluster_10
attagttgcggttgcggt	cluster_8
gaaggggtttcaaattgg	cluster_8
gctcccaattggccgatg	cluster_8
atccggtcgcctatccgg	cluster_8
ctcaatgcgcggcttgaa	cluster_8
gccagaatgaagcgttat	cluster_10
gccgtttggcagagtctg	cluster_8
gccagacgttatcggcgt	cluster_10
caaccgggattgttcttg	cluster_10
atagcgaaagaatgctaa	cluster_11
gctgaggagtgatggcag	cluster_8
catagaggccatagatgt	cluster_10
caaccgctcaatccgtaa	cluster_8
tctagcgccagagagtga	cluster_10
cttacggaaatacaagtc	cluster_8
tttgggcaggagcggtcc	cluster_8
gccagatctagctcgcct	cluster_11
cgttatcgaaagggattg	cluster_8
ccacgcgcgcgggagctt	cluster_10
gatcaactattatccaag	cluster_10
cgagcacgcatatctagc	cluster_8
tgtgtatttgggaacgtg	cluster_8
gagtgatatttcttcgca	cluster_10
ttaagaccacgcatgaag	cluster_10
aacagcgcttgtgcgaat	cluster_8
cgttatagacccggtagg	cluster_10
aggttagaggccttcttg	cluster_10
tcagtgaacgtgaaagaa	cluster_8
gccagaagtaaaaacagc	cluster_10
gatcaaatgaaggctccc	cluster_8
ttcgcattaagagctccc	cluster_8
ctattacaaccgtgttcg	cluster_10
atacttttggatacggac	cluster_8
actgcaagatgtcaggag	cluster_8
caaccgagtaaataatag	cluster_8
taccgatatttcattagt	cluster_8
atagcgagatgtgcgcgg	cluster_10
tgttcgtcatcacaggag	cluster_8
ccacgctcatcaactgca	cluster_11
gtttcaggtaggaattgg	cluster_8
atccggagtctgcaggag	cluster_8
cgaaagagtaaacaggag	cluster_8
atgaaggaaatacagact	cluster_10
ttgctcatccggatatac	cluster_8
agtctgggtaggagtctg	cluster_8
tttgggcgcataggtagg	cluster_10
ctattacaggaggactcg	cluster_10
tgtgtaagacccatactt	cluster_10
gcgaatcaaccggccgtt	cluster_10
gatcaagagcttcataga	cluster_10
acccaacatagagcttgt	cluster_10
tgcggtagcacgccacgc	cluster_10
tgctaaaagtatctcaat	cluster_10
gtggtgaagccaattagt	cluster_10
accttcagacccaccttc	cluster_8
cagactagtaaagcgaat	cluster_10
cggcgtatacttgaggcc	cluster_10
actgcatcagtggtggtg	cluster_8
taagctctattatcatca	cluster_10
ttcttgacaagggcgcgg	cluster_8
accttcactgcaatgaag	cluster_10
agtctgccacgctgagac	cluster_10
atgaagtgtgtatggcag	cluster_10
cggcgtatactttgagac	cluster_10
ttcttgggattgttcgca	cluster_8
acaaggtaagctgtcggc	cluster_8
tatttccgttatggattg	cluster_11
ggccatatccgggactcg	cluster_10
gagtgaagtaaaggattg	cluster_8
ctgtggtgttcgttgctc	cluster_10
cggcgttggcagcgttat	cluster_10
atataccaccacgtggtg	cluster_8
gagcttttcttgtgtgta	cluster_10
ggattgttgctcgggatc	cluster_10
ttggattgttcgatgaag	cluster_8
gaagggaaagaatgtgta	cluster_8
cggtccaagccaacggac	cluster_10
agatgtggtaggaagcca	cluster_8
tgcggtcgagcagatcaa	cluster_10
agacccatagcggggatc	cluster_8
tagaggcaaccgccacgc	cluster_10
tctagcgctccccaaccg	cluster_8
caggagcaaccgtgcggt	cluster_10
cagactggccatcaccac	cluster_8
ggccataacagcgtttca	cluster_8
ttcttgaagtatggtagg	cluster_10
tatttcagatgtcaagtc	cluster_11
tcgggatctagccagact	cluster_10
cttgaaacaaggtcatca	cluster_10
atatacattagtagtaaa	cluster_10
tgcggttgtgtaccgtaa	cluster_8
gtacagtgcggttgagac	cluster_10
tggcaggctccctcagtg	cluster_10
gtcctattggatgagctt	cluster_10
gccagaaagccagtggtg	cluster_8
cagactatgaagatagcg	cluster_10
cgttatcaagtcaagcca	cluster_10
tgagacaccttccgcata	cluster_8
acaaggctaggttatttc	cluster_10
gccgttgagcttcataga	cluster_10
gcttgtgtggtgtttggg	cluster_8
tcagtgtaagcttcatca	cluster_10
ggtaggattagtcaagtc	cluster_10
gctgaggtttcaatatac	cluster_10
gttaacctgtggtcggga	cluster_10
ggattgtatttcagtctg	cluster_8
cactgtgggatctgctaa	cluster_10
ttaagatatttctaccga	cluster_11
tgcggttagaggattagt	cluster_4
agcacgcagactgctccc	cluster_8
caagtccggtccctatta	cluster_10
ggccatgctgagaacagc	cluster_8
gaaatagtggtgcggtcc	cluster_8
caccacatgaagtatttc	cluster_8
ttggattctagcgctgag	cluster_10
ttggatctgtgggtcggc	cluster_8
gctgaggggatcggtagg	cluster_10
cgagcaagtctgcgttat	cluster_8
ttcttgatccggcaagtc	cluster_10
gaagggaccttccactgt	cluster_10
gactcgatacttttcgca	cluster_8
gtggtgggattgtaagct	cluster_8
ttcgcatccaagagtctg	cluster_10
gtcctaaattggagtctg	cluster_8
gtttcaatgaagatagcg	cluster_8
ccacgcactgcaactgca	cluster_11
gaagggcactgtctcaat	cluster_8
gcgcgggtcctagaaata	cluster_10
aggttagtttcactgtgg	cluster_10
gcttgtaagccaccacgc	cluster_8
aattggatatacggtagg	cluster_10
ggtaggggccattaatag	cluster_10
cagactgtttcagatcaa	cluster_8
ttgctcagatgtgctgag	cluster_11
atccgggagtgacttacg	cluster_10
agacccaagccaggattg	cluster_8
cagactctgtggggtagg	cluster_10
gaggccactgcaaattgg	cluster_8
tgtgtaattagtaaagaa	cluster_10
cctctagggatcaccttc	cluster_10
gggatcgggatccgaaag	cluster_10
caagtctgtgtaggattg	cluster_10
acccaaagatgtatccgg	cluster_10
agacccagtaaaaattgg	cluster_10
gaagggcgcatataagct	cluster_10
taccgaaaagaacgcata	cluster_10
atgaagtgttcgctgtgg	cluster_8
cggcgtgtacagaggtta	cluster_10
cgttatgaggccggacga	cluster_11
ccacgcggacgacagact	cluster_10
tgctaaacaaggcggtcc	cluster_10
tcagtgcggtccggtagg	cluster_10
cactgtgagcttatccgg	cluster_10
tagaggatccggagaccc	cluster_10
aagccaatacttgccaga	cluster_8
gcgaataccttcatagcg	cluster_10
tgttcgcttgaattgctc	cluster_10
ctgtggtaatagtggcag	cluster_10
acggacatccggtgcggt	cluster_8
tagagggcttgtgtccta	cluster_10
ttggatggccatatccgg	cluster_8
tccaagttggattatttc	cluster_11
cttacggtggtgactgca	cluster_10
gagctttgcggttaagct	cluster_10
ccacgcccgatgcggcgt	cluster_10
tgagaccaaccgtaccga	cluster_10
cactgtggtgcttcatca	cluster_8
gaagggtgctaaaacgtg	cluster_10
acccaaaacgtgacccaa	cluster_10
tcgggataagctgatcaa	cluster_8
gatcaatagagggatcaa	cluster_8
atactttcatcaagtaaa	cluster_10
aagccatatttctcagtg	cluster_10
aattggtgaattcaagtc	cluster_8
cactgtgtcctacaaccg	cluster_10
cgcatagcttgtgagtga	cluster_10
cagactgccagaacggac	cluster_8
gtcctacttgaacgcata	cluster_10
ggtaggacccaaaacgtg	cluster_6
tggcagtggcagacggac	cluster_10
acggacctgtggtgttcg	cluster_8
tagaggaccttcaccttc	cluster_10
tccaagaagccacaccac	cluster_8
cgaaagagatgtgtccta	cluster_10
ggccatccgtaaacggac	cluster_8
atacttcggcgtgaaata	cluster_10
ggccatcaaccggaaggg	cluster_10
caaccggaaatacaggag	cluster_1
tgtgtatgctaaaccttc	cluster_8
ggccatgtggtgtgtgta	cluster_10
gtggtgtgttcgttaaga	cluster_8
cagactttgctcttgctc	cluster_10
aagccagagctttaatag	cluster_10
taagcttcagtgagaccc	cluster_10
cctctaggattgcataga	cluster_10
ccgatgcaaccgtgctaa	cluster_10
acccaatggcagtaagct	cluster_10
caggagcactgttcatca	cluster_10
gaaataccgatgcataga	cluster_8
tcgggacaaccggctgag	cluster_10
gctgagtgtgtacagact	cluster_10
agcacgttggatttcgca	cluster_8
cctctaaggttactgtgg	cluster_10
attagttagaggattagt	cluster_10
gtcctaacccaagctccc	cluster_10
cgagcaggtgctatagcg	cluster_11
gccgttgaaggggagctt	cluster_11
tagaggccgatgtgtgta	cluster_10
tagaggttcttgggtgct	cluster_11
tctagcttcttgtggcag	cluster_8
gaggccgcgaatcttgaa	cluster_10
gccgttcgaaagtcgcct	cluster_8
gcgcggggacgaggccat	cluster_11
accttcactgcataatag	cluster_8
ccgatggtcctagtttca	cluster_8
agcacggctgagctcaat	cluster_8
tgcggtcagactaaagaa	cluster_11
gggatcaagccaggacga	cluster_11
ttaagatatttccttacg	cluster_10
gtttcatgagaccaggag	cluster_10
atactttgcggtatgaag	cluster_10
tcatcaagtctgaattgg	cluster_10
ctaggtccacgcttaaga	cluster_10
ggacgattggattaagct	cluster_11
tggcagttcgcaacggac	cluster_10
ttcttgctcaatttaaga	cluster_8
ccacgcccacgcccgtaa	cluster_10
gactcgatatacgaggcc	cluster_8
tgaattagcacgcataga	cluster_10
cgagcagccagattcgca	cluster_11
agcacgttcttggtcggc	cluster_10
aggttagccagagccaga	cluster_10
tatttccggcgtaaagaa	cluster_11
cggtccttaagacataga	cluster_11
ttcgcacggcgtactgca	cluster_8
ggacgatatttctaagct	cluster_10
gtggtgcagactcggtcc	cluster_10
ctaggtcgcatatcgcct	cluster_10
acaaggaacgtgggattg	cluster_10
ttcttgaccttccgttat	cluster_10
ctaggtcctctaagtctg	cluster_8
ctaggtgagtgaaagtat	cluster_10
gcttgttcgggatatttc	cluster_10
cactgtatccggcgagca	cluster_10
gaggccgcgcggctatta	cluster_10
acggacaattggcagact	cluster_10
atacttcttacgcagact	cluster_10
gactcgactgcacgcata	cluster_10
tgagacctgtgggctccc	cluster_10
cggcgttagagggctccc	cluster_10
agtctgcaggagcggtcc	cluster_10
agatgtgaagggccacgc	cluster_8
gaggccgttaacagtaaa	cluster_8
aggttatgcggtgctccc	cluster_10
gtacagtaataggtacag	cluster_10
gtggtgactgcacgagca	cluster_8
cctctagcgcggtagagg	cluster_10
atgaagattagtgagtga	cluster_8
tccaagtaagctagatgt	cluster_8
atacttcagacttcagtg	cluster_10
tggcagcggtccatatac	cluster_10
gaggccggtaggtctagc	cluster_10
catagaggtaggatccgg	cluster_10
ctcaatcatagattgctc	cluster_10
gcgaatggacgatcagtg	cluster_10
gagcttttgctcgtggtg	cluster_8
atagcgtgttcgcgcata	cluster_10
ctaggtctcaatcgaaag	cluster_8
tcagtgaattgggaaggg	cluster_8
cgcataccgtaattcgca	cluster_8
acccaaagcacgttggat	cluster_10
atacttgttaacaacgtg	cluster_10
gactcgtatttccgaaag	cluster_10
ggtgctagatgtgtcggc	cluster_8
tcgggagaagggccacgc1	cluster_10
tgagactcgccttgagac	cluster_10
tagaggagtaaaaacgtg	cluster_10
tgtgtagtttcaagtaaa	cluster_10
atacttacccaacaagtc	cluster_10
gctgaggagtgaaacgtg	cluster_8
gtcggcttaagaacaagg	cluster_11
tgaattgggatcacccaa	cluster_10
gggatcgactcgatccgg	cluster_10
ttcttgacccaagagtga	cluster_8
aacgtgagcacgcaccac	cluster_8
tttgggtatttctttggg	cluster_10
acggactcgggagaaata	cluster_10
ggccataacgtgacggac	cluster_11
atagcgtgtgtacggcgt	cluster_10
aacagcgttaacgggatc	cluster_10
tgcggtctcaataagtat	cluster_10
gaagggcttacgatgaag	cluster_10
catagatcgggaaacagc	cluster_10
tccaaggtcctagagtga	cluster_10
agcacgaagtatttaaga	cluster_8
cagactactgcagtacag	cluster_10
taccgagtcggccaagtc	cluster_10
gtttcagaaataccacgc	cluster_10
atacttaaagaatttggg	cluster_10
ctaggtactgcaacggac	cluster_10
gtacagagcacgtggcag	cluster_10
taatagccacgcacggac	cluster_8
aagtatgccgttaattgg	cluster_10
ttcgcacttacggcgaat	cluster_10
ttcttgcttacgatactt	cluster_10
gatcaagctgagatatac	cluster_10
cagactcaccacacccaa	cluster_8
cggcgtgaggccggtgct	cluster_9
aagtattaccgatgttcg	cluster_1
cttgaacggtccatactt	cluster_1
cgcataatatacgctccc	cluster_9
ttggatgaaataggacga	cluster_9
caggagcgagcagttaac	cluster_9
gtacagcaaccggactcg	cluster_9
atgaaggactcgggacga	cluster_9
agtaaaaagtatggtagg	cluster_9
tgcggtcgaaagcggtcc	cluster_9
aagtataggttaggtgct	cluster_9
acccaatgcggttctagc	cluster_9
cgaaagcttacgggtgct	cluster_9
ggtgctggccatttaaga	cluster_9
gagcttccacgctctagc	cluster_9
gaggcccttacgcgaaag	cluster_9
caccacgaggccgaaata	cluster_9
cgagcagtacagcagact	cluster_9
atactttagaggttaaga	cluster_9
gccgtttgaatttcatca	cluster_9
cgcataaattgggccgtt	cluster_1
aacgtgcaagtcccgatg	cluster_9
agcacgtcatcaaccttc	cluster_1
ctaggttgtgtacataga	cluster_9
tcatcatggcaggcgaat	cluster_9
gaaggggcgaatctcaat	cluster_9
gaaggggtcggcggacga	cluster_4
atccggtggcagagaccc	cluster_4
ttgctcaattggccacgc	cluster_4
tgaattactgcataatag	cluster_1
cactgttaagctgtccta	cluster_1
acccaacttacgccacgc	cluster_9
gtggtgggacgaccacgc	cluster_1
ttaagatcgcctgcgaat	cluster_1
tgcggtaaagaagcttgt	cluster_9
tttgggcctctactgtgg	cluster_1
cttacgggtagggtggtg	cluster_9
agatgttgttcgggtagg	cluster_9
aggttacaaccgatagcg	cluster_9
cactgtcactgtcaccac	cluster_4
cggtccaagtatctatta	cluster_9
atagcgacccaactatta	cluster_9
gatcaatgctaagactcg	cluster_1
agcacgttggatgaaata	cluster_9
cggcgtaattggcagact	cluster_4
cttgaattcttgggacga	cluster_9
ggacgaggattgttcttg	cluster_1
acccaaagatgtccgatg	cluster_1
gtggtggaagggcactgt	cluster_9
atagcgccgtaaatagcg	cluster_9
cctctagccgttggccat	cluster_9
ggtaggttcttgctatta	cluster_1
tttggggaagggcttgaa	cluster_10
gaagggggtagggcgaat	cluster_4
ttcgcaaggttaggtgct	cluster_1
caaccgacccaacggcgt	cluster_4
atatacgctccccaagtc	cluster_9
gccagactcaataggtta	cluster_1
gcttgtctcaatgtttca	cluster_1
tgtgtagtacagttcgca	cluster_4
tcgccttaccgatcggga	cluster_4
aggttacatagagccaga	cluster_10
cagactctcaatggattg	cluster_9
gcgcgggactcgcaccac	cluster_4
gtttcacactgtttcttg	cluster_1
tgctaagaggcccgagca	cluster_4
gaaggggccagacagact	cluster_9
gagtgaagtctgtggcag	cluster_4
gatcaaaggttatatttc	cluster_9
caggagcctctataccga	cluster_4
cttgaaggtaggcactgt	cluster_1
ggtgcttaagcttaagct	cluster_9
tgcggttaatagtggcag	cluster_9
aagccacgttatttggat	cluster_4
gccgttgtggtgacaagg	cluster_1
caaccgaacagcacggac	cluster_1
tcgggatgcggtaattgg	cluster_9
ccacgctgagaccaagtc	cluster_4
caagtcagcacgctaggt	cluster_1
ttggatggtgcttcatca	cluster_4
gggatcctattaaagcca	cluster_10
tctagccaagtctgagac	cluster_9
gaggccgcgaatttcgca	cluster_1
gatcaaagacccgtttca	cluster_10
aagtatcactgtccgtaa	cluster_1
tcatcacgcataatgaag	cluster_10
catagatgctaacgagca	cluster_9
gtcctacttgaactgtgg	cluster_4
gtttcaaacagctgaatt	cluster_1
taatagtaccgaaacgtg	cluster_10
gcgaatgccgttcgcata	cluster_9
cactgtcagactgctccc	cluster_9
atagcgatccggttcttg	cluster_1
atacttgggatcgtttca	cluster_10
gtcggctgagactgcggt	cluster_4
gaaataagatgtaaagaa	cluster_9
ggccatctgtgggaaggg	cluster_4
catagatcagtggagctt	cluster_4
gttaactaagctcaagtc	cluster_1
agcacgtgcggtcttgaa	cluster_10
ttcttgcggcgttaagct	cluster_2
gttaactttggggtttca	cluster_9
ggtgctaacagcggattg	cluster_10
atactttccaagaagcca	cluster_1
aattggtgctaagcgcgg	cluster_4
tcatcatcgcctttggat	cluster_9
cgcatagcgaatcgttat	cluster_1
aagccagtacagaattgg	cluster_10
ttgctcttaagaggacga	cluster_9
actgcaacccaaggtgct	cluster_10
attagttgagacagaccc	cluster_10
cagactttcgcacgagca	cluster_1
tatttctcgccttgttcg	cluster_1
caaccgtcgcctaacgtg	cluster_10
aagccacctctaatgaag	cluster_4
catagatgtgtaaaagaa	cluster_9
tcagtgtcgcctgaaggg	cluster_10
actgcatgttcgagcacg	cluster_1
ttaagactaggtatgaag	cluster_10
caagtcttggatcttacg	cluster_1
aaagaaatatacttggat	cluster_1
ggtaggttgctctcatca	cluster_6
atataccaggagtaagct	cluster_9
agtaaagtttcaatactt	cluster_3
cgaaagggtgctttggat	cluster_1
ctattaaccttcctaggt	cluster_10
cactgtcctctaggccat	cluster_10
ctaggtatacttaaagaa	cluster_1
gcgaataggttatggcag	cluster_6
gggatcgtttcacgttat	cluster_1
cttacgggtaggatgaag	cluster_1
ttcgcaatccgggactcg	cluster_1
ttcttgcaggagatagcg	cluster_11
agtaaagcgaatattagt	cluster_9
tccaagtctagcggacga	cluster_1
ttggatccgtaaagcacg	cluster_9
aagccagtggtgtgtgta	cluster_4
taatagtcgggaaaagaa	cluster_10
cggtcctttggggagtga	cluster_1
agacccagcacgtcggga	cluster_4
cgaaagctgtggcggtcc	cluster_9
gtcctaaaagaacgaaag	cluster_1
aggttacgagcaccacgc	cluster_1
cagactcactgtcttacg	cluster_9
gaggccacggaccgagca	cluster_1
ttggatcaccacagtctg	cluster_4
gtggtgacaagggtggtg	cluster_4
aagtattaagctctgtgg	cluster_1
cctctaaggttaggccat	cluster_10
tgagactgctaagatcaa	cluster_1
tctagcgaggccaaagaa	cluster_10
cgagcaatacttgcgaat	cluster_1
taatagtatttcaacagc	cluster_1
tgtgtaagcacgcttgaa	cluster_1
taagctgccagactatta	cluster_11
cgagcacatagaccgtaa	cluster_9
agatgtcttacggggatc	cluster_11
gagcttgccgtttcagtg	cluster_4
attagtcctctatatttc	cluster_1
cgaaagttggatgccgtt	cluster_6
aattggtggcagtgaatt	cluster_10
tcgcctttggatcttacg	cluster_1
taagctgagcttctgtgg	cluster_11
aaagaacggtccggtagg	cluster_9
agtaaacgagcattcttg	cluster_1
gcgcggatacttcttgaa	cluster_11
gagcttcgcataagcacg	cluster_1
cttgaagaagggaacgtg	cluster_1
gagtgacaaccgacaagg	cluster_9
aacagctagaggtctagc	cluster_1
ttggatggtaggctcaat	cluster_1
gagtgagttaacatactt	cluster_1
gctgagggtaggcgagca	cluster_1
tttgggatacttggccat	cluster_1
atatacctattactgtgg	cluster_9
agtctgttaagaaacagc	cluster_11
caccacgaaatattgctc	cluster_1
acggacgtggtgcataga	cluster_6
atgaagccacgctaagct	cluster_1
taatagttgctctgtgta	cluster_5
tgagaccctctagatcaa	cluster_1
ctaggttgttcgctaggt	cluster_1
tagagggccagaattagt	cluster_1
ctaggtcactgtccgtaa	cluster_1
gatcaagcttgtcgttat	cluster_1
ggattggatcaagagtga	cluster_1
cactgttgcggtaattgg	cluster_1
tctagcgatcaacactgt	cluster_1
ggacgacgaaagactgca	cluster_1
cttacgaagtatccgtaa	cluster_9
attagtgaggccggtagg	cluster_1
cttgaataccgatcagtg	cluster_1
tcagtgaattgggagctt	cluster_1
agtctggcttgtgcgcgg	cluster_2
agtctgtgttcgttcttg	cluster_1
acaagggaggcccttacg	cluster_9
ttggataattgggtacag	cluster_1
gaagggagtctgtgttcg	cluster_1
atccggcgaaaggaaggg	cluster_1
gttaacaacagcacaagg	cluster_1
taccgattcgcagaaggg	cluster_1
cttgaacaagtctagagg	cluster_1
agtaaaacccaagaaata	cluster_1
gatcaatgagacgactcg	cluster_9
tgcggtactgcagtcggc	cluster_1
gtcggcgaggcccaagtc	cluster_1
gccagagtcctaagaccc	cluster_1
ttcgcatccaagtggcag	cluster_2
gttaacgcgaataaagaa	cluster_1
ctaggtatgaagcttgaa	cluster_2
cctctatctagcgccgtt	cluster_1
cgcatacatagatcggga	cluster_2
cggcgtttggatgctgag	cluster_1
tctagctaatagaacagc	cluster_9
atccggagtaaacctcta	cluster_2
tccaagttcttgctatta	cluster_9
cggcgtagatgttaatag	cluster_1
tcgggagcgcggaacagc	cluster_1
aacagcaacagcgtcggc	cluster_4
tgcggtacccaactaggt	cluster_1
attagttgctaacttgaa	cluster_1
ttcgcacaaccgccgtaa	cluster_1
aacgtgatccggatagcg	cluster_1
agcacgttaagagtttca	cluster_1
agtctgatgaaggcttgt	cluster_1
cttgaaggccatccgtaa	cluster_2
agatgtaacgtgtatttc	cluster_4
gggatcgtcctaatactt	cluster_1
tctagcccgtaaatccgg	cluster_1
cggtccgcgcgggaggcc	cluster_1
tgtgtagctgaggactcg	cluster_1
cgttatcagactccgtaa	cluster_1
aacgtgctcaatgtacag	cluster_1
tgaatttcagtggctgag	cluster_1
aattggtgcggtgaggcc	cluster_1
cactgttaagctgtggtg	cluster_10
gaagggtgcggtcggtcc	cluster_1
gcgaattgttcgtaatag	cluster_2
tcatcaaaagaacactgt	cluster_1
acggaccaggagcactgt	cluster_9
tagaggccacgccgagca	cluster_1
cgaaagtggcagccgatg	cluster_1
cgcataacccaatccaag	cluster_1
attagtacggacacaagg	cluster_1
gactcgcgagcagagctt	cluster_4
ttaagacttgaaacccaa	cluster_1
atgaagaccttcgctccc	cluster_1
aacgtgcgaaaggccaga	cluster_1
gactcgccgatgtaatag	cluster_1
tgagacatacttgaaata	cluster_1
caccaccggtccgtcggc	cluster_1
aagccataagctattagt	cluster_1
atagcgcaaccgaagcca	cluster_1
ggtgctattagtatactt	cluster_1
aacagcgtcggcaagcca	cluster_1
ctaggttgagactcatca	cluster_10
agatgtccgtaaccgatg	cluster_9
tcgcctcactgtaaagaa	cluster_1
gcttgtaacagcccgatg	cluster_2
gagtgaatatactaccga	cluster_4
gcgcggtgagacttggat	cluster_2
caggaggagtgaaaagaa	cluster_1
caagtcaaagaattcgca	cluster_1
gagcttggtaggtcgcct	cluster_1
ggattgcgagcagccgtt	cluster_1
cgcataactgcacactgt	cluster_1
atatacacaagggcgaat	cluster_1
gtcggcagatgtcaaccg	cluster_1
accttctatttcgtggtg	cluster_11
gagcttatccgggtcggc	cluster_4
atccggatacttctgtgg	cluster_2
ctcaattctagcttggat	cluster_1
ttcttgcgagcactcaat	cluster_2
cggtcccaccactgtgta	cluster_2
cggcgtcgaaaggtacag	cluster_1
atagcgagacccgatcaa	cluster_2
gaaatattaagattcgca	cluster_2
actgcagaaataatagcg	cluster_1
accttccgaaagccacgc	cluster_9
cgcatatcagtgcaccac	cluster_1
tatttcgaggcctgctaa	cluster_1
gtttcacgttattaagct	cluster_1
tgctaaatagcgtctagc	cluster_2
ttaagagtacagaacgtg	cluster_1
ttgctcatgaagtgctaa	cluster_1
tgagacgcgaatgctgag	cluster_1
tttgggattagttttggg	cluster_1
tcagtgcgagcacagact	cluster_1
gctcccgagcttgatcaa	cluster_2
tggcaggtcctatggcag	cluster_1
ccgatgtgctaaatactt	cluster_2
aacgtgcgttattaagct	cluster_1
attagttgaattaattgg	cluster_1
cgagcagagtgaccgtaa	cluster_2
agatgtttcgcatcagtg	cluster_1
aacagcatatacgatcaa	cluster_1
gttaactcagtgtaagct	cluster_1
atacttcatagacttgaa	cluster_1
tgtgtataatagaggtta	cluster_1
ccgatgaggttataatag	cluster_2
atagcgaacagcaaagaa	cluster_1
gtcctagctgagctaggt	cluster_2
agaccccggtcctgtgta	cluster_1
cactgtaccttctaatag	cluster_1
cgttatggattgacaagg	cluster_6
caggagaacgtggagctt	cluster_2
cgagcaattagtttaaga	cluster_2
cgttatgaagggatagcg	cluster_2
gtggtggtttcaaggtta	cluster_2
caccacgatcaaggattg	cluster_10
ggacgattcgcagccgtt	cluster_1
tgttcggcttgtcaaccg	cluster_1
gactcgtcgcctacggac	cluster_1
tgttcgtgtgtaatatac	cluster_1
cagactgaaatagcttgt	cluster_9
cttgaagaaataggtagg	cluster_11
tggcagattagtcgcata	cluster_2
taatagaccttctatttc	cluster_1
cttacggactcggtacag	cluster_2
acccaaggacgagtccta	cluster_1
ggacgagatcaagtacag	cluster_2
ctcaatactgcaaagtat	cluster_1
caagtcggccatttggat	cluster_2
cgcatatagaggtaagct	cluster_1
gcgcggtggcagacaagg	cluster_1
atccggagtaaatgttcg	cluster_2
attagtgcgcggaggtta	cluster_1
ctattaggacgagactcg	cluster_2
gtggtgcgttatagtaaa	cluster_1
accttcacaaggacccaa	cluster_2
tggcagggccatcgagca	cluster_9
taccgaccacgcttcgca	cluster_1
gtacagcatagacgttat	cluster_4
caagtcggtaggcgttat	cluster_2
atatacatgaagattagt	cluster_2
atgaagtttgggctaggt	cluster_2
ttggatttcgcagtttca	cluster_1
aacgtgtgcggtttggat	cluster_6
gaaatacgcataatatac	cluster_6
gccgtttggcagaccttc	cluster_1
cttgaaggacgatcatca	cluster_1
tgttcgggtaggctcaat	cluster_2
cgttatttcgcatgcggt	cluster_2
tgctaacggtcctgctaa	cluster_2
atgaagttcgcagactcg	cluster_1
ggtaggggattgtaccga	cluster_1
tccaaggcgaatgactcg	cluster_2
tatttcgcttgtcagact	cluster_1
tggcagatccgggtggtg	cluster_1
tgagacgagcttcttgaa	cluster_2
aattggggacgatgttcg	cluster_11
gactcgtgagactggcag	cluster_1
tagagggaggcccttacg	cluster_9
gggatcacaaggatccgg	cluster_1
tgtgtacaaccgccgatg	cluster_1
gccgtttccaagctaggt	cluster_1
ggattgtgaattgcttgt	cluster_9
ttcttgccgtaagctgag	cluster_2
gtggtgagatgttatttc	cluster_2
caaccgaattgggccgtt	cluster_2
aacagcttgctcagaccc	cluster_2
gtttcaattagtttaaga	cluster_2
gttaactgttcggtacag	cluster_2
tagaggaacgtgtctagc	cluster_2
agacccttaagagccaga	cluster_2
aacgtggcgcgggtccta	cluster_1
tcgcctggacgattgctc	cluster_1
cggtccgagtgagccaga	cluster_11
gctcccgtggtggactcg	cluster_2
atccggactgcacgaaag	cluster_1
agatgtggattgggtagg	cluster_2
acggacagatgttcgcct	cluster_2
atccggctaggtgtacag	cluster_1
gccgtttgagacgaaggg	cluster_1
tttggggaaatactgtgg	cluster_2
caaccgcgaaagaagcca	cluster_8
gtggtggaggcccaagtc	cluster_2
agatgtagtctgggtgct	cluster_2
atacttgccgttattagt	cluster_1
cctctatcgggatcggga	cluster_2
aagccacaaccgaattgg	cluster_1
taccgaagatgtccgtaa	cluster_1
ttaagaatatacggacga	cluster_1
tgaattagtaaaaggtta	cluster_2
tgttcgctgtggtcgcct	cluster_2
agcacgcaggaggaaata	cluster_2
gttaacacccaatcggga	cluster_11
cggtcctgaattcgagca	cluster_2
gtggtggcttgtaagcca	cluster_1
cggtccaacagcgcgaat	cluster_1
gtggtgggattggtttca	cluster_1
cgaaaggatcaataagct	cluster_10
ccacgcctaggtgctgag	cluster_1
acggacgatcaaatatac	cluster_1
cggcgtgcttgtaacgtg	cluster_1
tgaattcaccaccgcata	cluster_2
caaccggactcgcgcata	cluster_2
cggtccgagcttgctccc	cluster_2
tgagactttgggaattgg	cluster_1
ccacgcagaccctttggg	cluster_2
aacgtgcgagcataccga	cluster_1
tcgcctgttaacctatta	cluster_1
ccacgctcatcacaaccg	cluster_1
tcatcaagatgttctagc	cluster_1
caagtcacccaactcaat	cluster_1
ccgtaaaattggaacgtg	cluster_2
gccagaagatgtagtaaa	cluster_2
atatacgctgagatactt	cluster_1
tgtgtacatagaatccgg	cluster_2
tttgggctcaatgctccc	cluster_1
ttaagaaagtatgccgtt	cluster_4
gggatcaagtatcggtcc	cluster_2
tcatcacaaccgtatttc	cluster_2
gctgagcgcatattaaga	cluster_2
taagctgggatcgctgag	cluster_1
accttcccgtaaaagtat	cluster_1
atccggtcatcatgttcg	cluster_2
aggttaaagtattgcggt	cluster_2
atagcgaggttagactcg	cluster_2
tctagctgcggtagtaaa	cluster_1
ggccatgagtgacttacg	cluster_9
cggcgttagaggccgtaa	cluster_2
aagtatcgagcaagatgt	cluster_2
tcatcagcttgtcaccac	cluster_2
tcgcctaagtattcgcct	cluster_10
ttgctcccgatgacggac	cluster_2
tcagtgtttggggggatc	cluster_9
gtggtgcatagaaccttc	cluster_1
caaccgagtaaacgcata	cluster_11
tgctaaagatgtcaaccg	cluster_1
ctcaatttcgcaaattgg	cluster_1
catagacttgaatcatca	cluster_1
ctaggtcatagaagatgt	cluster_1
cactgtgggatctcatca	cluster_2
caggagcttgaatgtgta	cluster_1
gactcggtacagatccgg	cluster_1
ggtaggagtctgaagtat	cluster_2
gcttgtcatagaccacgc	cluster_2
gcgcgggaggcccttacg	cluster_9
gagctttttgggctgtgg	cluster_2
attagtggtagggtccta	cluster_2
agtaaaggacgactgtgg	cluster_2
ctattaatataccttgaa	cluster_1
tgaatttaagctggtgct	cluster_1
cttgaaggccatgcttgt	cluster_7
gagcttgagcttagtctg	cluster_1
agtctgcgaaagttaaga	cluster_7
aagccactgtggcaccac	cluster_1
ccgtaaaagtatggtagg	cluster_7
gcgaatgctcccttcttg	cluster_1
gcttgtgtcctagaggcc	cluster_1
atacttcaaccgcttacg	cluster_4
tcgcctcatagattcgca	cluster_4
gctgagggccattaccga	cluster_7
gcttgttgagactgtgta	cluster_4
agacccgttaacgactcg	cluster_7
aacgtgcgagcaggtgct	cluster_4
tgagacgaagggtagagg	cluster_1
cagactttcttgtgcggt	cluster_4
tcagtgttcgcaatactt	cluster_7
ccacgcaccttcgagtga	cluster_7
caagtcgctgaggtacag	cluster_4
atatactgctaatgctaa	cluster_6
ttgctcatactttttggg	cluster_4
actgcaacccaaatatac	cluster_1
aggttagtggtgtcgcct	cluster_7
gaggccgcgcggtccaag	cluster_7
taatagtccaaggcgcgg	cluster_1
agacccatccggttgctc	cluster_1
ccacgcacccaaaattgg	cluster_7
caggagtctagcctcaat	cluster_7
atatacccacgcgaaggg	cluster_10
cgaaagtcgggaaacgtg	cluster_6
tatttctaagctgctccc	cluster_11
atagcggccgtttcatca	cluster_4
tgtgtatgtgtacggtcc	cluster_1
cttgaacttgaacttacg	cluster_7
tcatcagctcccacccaa	cluster_1
ggtgctcaaccggaaata	cluster_4
caaccgtctagcggtagg	cluster_6
gcttgtgtcggcattagt	cluster_5
ttgctcaggttagaaggg	cluster_4
gagcttgcgaatgctgag	cluster_11
ccgatgaagccaaggtta	cluster_5
gggatctgttcgaaagaa	cluster_5
gatcaacactgttcagtg	cluster_4
cggcgtagatgtgagctt	cluster_5
ttggatgtacagcctcta	cluster_7
accttcgatcaaccacgc	cluster_4
accttcctcaatgtacag	cluster_5
aagccattcgcaatactt	cluster_4
gtcggcgctcccacaagg	cluster_6
tccaagaacgtgctatta	cluster_4
cctctaatagcgagcacg	cluster_5
tgagactaatagcttacg	cluster_6
aagccatgtgtacaccac	cluster_6
cactgttagagggccaga	cluster_5
atacttcaggagaattgg	cluster_5
caggagtcgggatcggga	cluster_5
tgttcggaaataatactt	cluster_4
atccggtggcagacaagg	cluster_6
caagtcgaagggtatttc	cluster_5
ttaagaaggttacataga	cluster_5
tgctaaagatgttcatca	cluster_6
acccaagactcgggtagg	cluster_5
tcgggagtacaggccaga	cluster_6
gcttgtcgttatgaaata	cluster_1
catagacttgaatgcggt	cluster_6
caggagttgctcgcgcgg	cluster_6
gctcccccgtaataatag	cluster_6
gactcgatacttaacagc	cluster_6
gcgaatgccgttgcgaat	cluster_6
agtaaattcgcagccaga	cluster_6
tccaagtggcagaccttc	cluster_11
tgctaatgaattatactt	cluster_6
tggcagcaccacgctccc	cluster_6
atacttgagtgagtacag	cluster_6
atacttgagcttcataga	cluster_6
tgctaatccaaggcgaat	cluster_5
aacagcttcttgtaatag	cluster_7
gcttgtagtctgtagagg	cluster_6
agaccccttgaagcttgt	cluster_5
gttaacgcgcgggagtga	cluster_6
gactcgcaagtctgctaa	cluster_6
gagtgaaacagcctcaat	cluster_6
caagtcagtctgcctcta	cluster_7
cgcataggtgctaacgtg	cluster_6
atacttgtacaggtacag	cluster_6
cgcatagctgagagtaaa	cluster_6
ctaggtggtgctcttacg	cluster_7
acccaaactgcaatactt	cluster_5
gtcggcaggttagtacag	cluster_6
gtggtggactcggtcggc	cluster_6
acccaagagcttgtggtg	cluster_6
ccgatgtaatagctcaat	cluster_6
caagtcgactcggtcggc	cluster_6
ttaagagctgaggactcg	cluster_6
cgagcaaccttcctgtgg	cluster_5
ttcgcactcaatcctcta	cluster_6
caccacgaaataaccttc	cluster_5
ggtaggggtgctcataga	cluster_6
ttaagagccagatgaatt	cluster_6
taatagcgcatagtccta	cluster_5
taccgagaaataggtagg	cluster_6
cagactacggactgctaa	cluster_6
aacagcggacgatcagtg	cluster_11
ccgatgaagccatccaag	cluster_5
ctgtggtcatcaatactt	cluster_6
cggtccccgtaatctagc	cluster_6
cgcatagactcgccgtaa	cluster_6
tggcagccgatgggccat	cluster_6
gtcggccggcgtgatcaa	cluster_6
gagcttgaggccaattgg	cluster_6
ggccatgaggcccataga	cluster_7
atccgggcgaatctatta	cluster_6
gcgcgggactcgaagcca	cluster_6
gaggcccaccacaattgg	cluster_6
agcacgcagacttcagtg	cluster_6
tcgggaagacccaccttc	cluster_6
catagacaagtcaagtat	cluster_6
gtcctagtacagcataga	cluster_6
ctattaagtctgagatgt	cluster_6
cactgtcttacgccacgc	cluster_6
ttaagaccgtaagactcg	cluster_11
agatgtcactgttgctaa	cluster_11
ctattagagcttgcgcgg	cluster_5
atgaagctcaataaagaa	cluster_5
ttgctcagtaaacgagca	cluster_5
gctgagtatttctgttcg	cluster_6
agatgtgtcctacaaccg	cluster_6
aaagaacttgaagcgaat	cluster_5
tccaaggtacagttgctc	cluster_7
accttcaccttcgaggcc	cluster_6
cgagcataagctatgaag	cluster_6
tagagggagtgacagact	cluster_6
ggtgcttgaattgccaga	cluster_6
tcagtgtgttcggcgcgg	cluster_6
tcagtggctcccgcgcgg	cluster_5
agatgtaacagcggattg	cluster_6
ggacgagtcctacaccac	cluster_6
atactttaataggcgaat	cluster_5
tcatcaggccatcctcta	cluster_6
tagaggatatacaggtta	cluster_6
gcgcggatccggccacgc	cluster_6
cgagcatctagcgcgaat	cluster_5
gccagacaaccgaagtat	cluster_6
agatgtctaggtagaccc	cluster_1
tttgggacaagggcgcgg	cluster_6
caccacccacgcttgctc	cluster_6
gccgttcgttatgactcg	cluster_6
gtggtgtgagaccagact	cluster_6
gatcaacggcgtattagt	cluster_5
tcagtggtcctagtccta	cluster_6
gtcggctgttcggtttca	cluster_6
gaaggggctgagcataga	cluster_6
tgagacctaggtgggatc	cluster_6
ggattgcaagtctctagc	cluster_6
cgagcagtttcaaccttc	cluster_6
ggtaggtcgggagactcg	cluster_6
ttgctccttgaacctcta	cluster_6
cttacgaccttctccaag	cluster_5
tcgggattggatagatgt	cluster_6
tcatcagtttcatggcag	cluster_6
gagtgagaaggggaaata	cluster_6
tgaattgagcttttaaga	cluster_5
agtaaacggcgtcgaaag	cluster_6
ggtaggcttgaatgtgta	cluster_7
aacagcgtcctaggacga	cluster_6
ggtaggggtaggtaccga	cluster_11
gcttgtctcaatccacgc	cluster_6
gtggtggaagggagtctg	cluster_6
ggtaggtatttcactgca	cluster_5
aacgtgcttgaaaacgtg	cluster_6
gccagaaacgtgggtgct	cluster_5
gatcaaaaagaacaagtc	cluster_6
atgaagtagagggactcg	cluster_10
tgttcgcgagcacggcgt	cluster_6
ccgtaagcgcggtgttcg	cluster_6
agcacgcttgaataatag	cluster_6
gccgttcgagcacttgaa	cluster_6
ccgatgacccaacaagtc	cluster_6
gtttcagtcctatgaatt	cluster_6
caaccgcagactcgagca	cluster_5
gttaacaggttaagatgt	cluster_6
catagatggcagtcggga	cluster_6
aaagaaccacgcagtctg	cluster_6
aggttacgagcatttggg	cluster_6
cagactccacgcaacagc	cluster_6
ttcgcacaagtccgaaag	cluster_6
cgttatcaaccgtgcggt	cluster_6
ccgatgggattggccaga	cluster_6
cgcataagatgtttgctc	cluster_6
gttaacttcgcatttggg	cluster_6
atagcgcaaccgaagtat	cluster_5
gggatcaattggaacagc	cluster_5
aggttaccgtaacggcgt	cluster_5
tcgcctttcttgcctcta	cluster_6
tgagactcgggaaagtat	cluster_6
ttggataacagctctagc	cluster_11
ttcttggtggtgagcacg	cluster_6
acaaggcactgtgatcaa	cluster_11
actgcaatagcgtctagc	cluster_5
cgcatatccaaggcgcgg	cluster_5
atagcgagcacgacggac	cluster_1
tagaggtctagcatactt	cluster_6
accttctcagtgtcagtg	cluster_6
tgttcgttgctcgccgtt	cluster_5
ggattgctaggtaggtta	cluster_6
ttcttgctattagtccta	cluster_6
taagctcggcgtgcttgt	cluster_6
tgctaaatagcggccaga	cluster_6
gtcctaactgcacaggag	cluster_6
atatacgaaataggccat	cluster_6
aagccatgaattcgaaag	cluster_6
gagtgacaccacaaagaa	cluster_6
gaggccgagcttggtgct	cluster_6
ccgtaacaaccgacaagg	cluster_6
taatagcaaccgaaagaa	cluster_5
ttgctcaccttcgccaga	cluster_5
atatactgctaataccga	cluster_6
gaggccatgaagcggtcc	cluster_6
ttggatgatcaatccaag	cluster_6
aacgtgcttgaagagtga	cluster_4
tagaggctaggtttaaga	cluster_6
cagacttctagcctatta	cluster_6
ttcttggcgaatatgaag	cluster_4
agacccaccttcccgtaa	cluster_6
catagactgtgggatcaa	cluster_6
tgagacggtgcttcgcct	cluster_6
cgcatatcatcagactcg	cluster_6
gccagaaagccacgaaag	cluster_6
cgcataagaccccaaccg	cluster_6
aagtatactgcactatta	cluster_6
ttcgcaagaccccggtcc	cluster_4
ttgctctgaattggtagg	cluster_6
gagcttcctctagtacag	cluster_6
atatacctattaagtctg	cluster_6
cggcgtgctgagagtaaa	cluster_10
ttcgcaattagttgttcg	cluster_6
atatacttgctcgaaggg	cluster_6
catagaaattggaacagc	cluster_3
catagacagacttctagc	cluster_3
gagctttaatagaccttc	cluster_3
tagaggctcaataattgg	cluster_3
acaaggcaccacccgtaa	cluster_3
tgagaccgttataggtta	cluster_3
caaccgggacgataccga	cluster_3
atccgggcttgtcgaaag	cluster_7
ttcttgcctctagaggcc	cluster_3
ccgtaaaattggctcaat	cluster_3
ggtaggcgaaagacaagg	cluster_3
taatagcctctacggtcc	cluster_7
ttcttgccgatggtcggc	cluster_3
gggatcaccttcggacga	cluster_3
accttctgaattgatcaa	cluster_4
cggtcctggcagcaaccg	cluster_9
ggtagggatcaacggtcc	cluster_3
catagaccgatgcttgaa	cluster_3
tgcggttgaattatactt	cluster_7
tgctaatgaattccacgc	cluster_7
tctagcaacagcccgtaa	cluster_7
caggagggccatatatac	cluster_3
ccgatggggatcatactt	cluster_3
gactcggatcaaaattgg	cluster_9
aacgtggagcttaccttc	cluster_3
gactcgattagtctatta	cluster_3
ttcgcatccaaggaaata	cluster_7
gctgagatatactaatag	cluster_4
tgaatttgttcgtgtgta	cluster_9
gagcttaagccaaacagc	cluster_4
cagacttgcggtccgtaa	cluster_3
tccaagcactgtatactt	cluster_4
aattgggagtgatgtgta	cluster_10
gtacaggtggtgttggat	cluster_3
gccgttgtttcaaacagc	cluster_7
acaaggggacgacctcta	cluster_9
gcgcggtgttcgttcgca	cluster_4
gatcaatgctaattaaga	cluster_3
gctgagcagactcagact	cluster_3
cttgaatcgcctgagctt	cluster_9
acggacaagtatactgca	cluster_3
cactgttaccgagactcg	cluster_9
ggtaggcttgaatcgcct	cluster_9
gagtgaaattggttcgca	cluster_4
ggtaggcggcgtaagtat	cluster_4
tgtgtaacccaaacggac	cluster_3
gcgaatcaaccgcggcgt	cluster_3
ttcttgagaccccagact	cluster_3
caccactagagggaaggg	cluster_3
ggtaggaaagaacgttat	cluster_3
cgttatattagtaccttc	cluster_4
taagctagtaaaccacgc	cluster_3
tatttcagtctgatccgg	cluster_3
cgcatacggcgtctcaat	cluster_9
gctcccaagtatactgca	cluster_3
tagagggactcgatgaag	cluster_3
tgttcggtggtggccgtt	cluster_3
tgttcgacaaggaattgg	cluster_3
ggtgctgccgttccgtaa	cluster_3
tgaattgttaaccactgt	cluster_3
caccaccggcgtgtccta	cluster_3
acaaggattagtgtttca	cluster_3
tttgggaattggatgaag	cluster_3
cgagcatgctaaatactt	cluster_3
atgaagatacttcgagca	cluster_3
gagtgagtacagagtctg	cluster_7
ctgtggattagtccgatg	cluster_7
cggcgtgagcttaattgg	cluster_3
aacagctcgggacaaccg	cluster_3
caagtcacaaggcctcta	cluster_3
cgaaagagacccgtccta	cluster_4
gaagggacccaatggcag	cluster_3
tctagcatccgggcgcgg	cluster_3
taatagaccttcgaggcc	cluster_10
tgagaccttacgttgctc	cluster_3
gtttcaggacgagaaata	cluster_9
gatcaaaacgtgctcaat	cluster_3
gtcctatttgggttcttg	cluster_3
caccactcgcctcgaaag	cluster_9
ttggatgtggtgtgtgta	cluster_3
atagcgacccaagaaata	cluster_3
tccaagagtaaatgtgta	cluster_3
tgtgtattggatactgca	cluster_4
ggacgatgtgtaacggac	cluster_3
ggtgctgcgaatggccat	cluster_3
tcagtggtacagcaaccg	cluster_9
tcgggagaggcctcgcct	cluster_3
cttacggccagagcgcgg	cluster_3
attagtgagctttcagtg	cluster_9
caagtccggcgtgaggcc	cluster_4
tccaaggaaggggctccc	cluster_3
gaagggaacagcaagtat	cluster_10
ttggatcaccacatgaag	cluster_3
atgaagatgaagacaagg	cluster_3
actgcacgcataagatgt	cluster_3
tagaggtccaagaccttc	cluster_3
tcgcctccgatgatgaag	cluster_4
tggcagtatttcggacga	cluster_3
cgttattcagtggctccc	cluster_3
actgcaaaagaagccaga	cluster_3
agtaaaatgaagcaagtc	cluster_3
atactttaagctccgatg	cluster_10
atacttccacgcggtagg	cluster_3
agacccggattgtagagg	cluster_4
aagtatcttacgatatac	cluster_3
agtaaaatatacacggac	cluster_3
ccacgcacaaggggacga	cluster_10
caagtcaattggtaccga	cluster_11
agatgtgtcctaacaagg	cluster_7
taccgaagtaaatcagtg	cluster_3
cgcatagtttcaaattgg	cluster_3
gagcttgagcttggccat	cluster_3
cgagcagatcaagttaac	cluster_3
cactgttcagtgccgtaa	cluster_3
cactgtgagtgagtggtg	cluster_3
ggacgacggcgtttcgca	cluster_4
acaaggatactttgttcg	cluster_3
ctgtggttaagaatactt	cluster_3
ggtaggcctctacactgt	cluster_3
agtctggtcctagccaga	cluster_3
tccaagaccttcgggatc	cluster_3
ttcttgcggtcctctagc	cluster_6
tgagacacccaaaggtta	cluster_3
tatttcagatgtgctgag	cluster_3
tcatcattcgcaaacgtg	cluster_3
ttgctctgagacagatgt	cluster_10
cactgtaacagcaattgg	cluster_4
tgaattaacagccagact	cluster_6
tctagcccgatgcaaccg	cluster_3
agtaaacaggaggagctt	cluster_9
atgaagaacgtgtagagg	cluster_3
caaccgcaggagatactt	cluster_10
gggatcatccggatactt	cluster_3
tgttcgactgcagtccta	cluster_3
acaaggcaccacatactt	cluster_11
aagtatacggacggacga	cluster_3
tcgcctctaggttagagg	cluster_3
gaaataatgaaggtcggc	cluster_3
atatacagtctgccacgc	cluster_6
atgaagagtctgccacgc	cluster_3
caaccgcttgaaatagcg	cluster_4
ggtagggagtgatgtgta	cluster_10
ttcgcaaagccactatta	cluster_9
gtggtgcctctataccga	cluster_3
tctagcgtacagtgctaa	cluster_3
gaggcccactgtcgaaag	cluster_11
acaaggtcatcaaggtta	cluster_3
gctgagagcacgaaagaa	cluster_6
gaagggagtctgttcttg	cluster_6
cgttattcatcagcgaat	cluster_3
cgcataatagcgccacgc	cluster_3
tgagacctcaatagaccc	cluster_3
gtcctaaagccagaaggg	cluster_7
gagtgagcgcggaccttc	cluster_3
gggatcgaggcctggcag	cluster_11
ggtaggcgttatttggat	cluster_3
ctcaatgtttcaaagcca	cluster_1
tgctaacgagcaccgtaa	cluster_6
ctaggtggtaggctcaat	cluster_6
gatcaagctgagtggcag	cluster_6
gtttcaggattgcggtcc	cluster_9
catagaatatacctaggt	cluster_3
cggtccaccttctatttc	cluster_9
ttaagacttgaaccgtaa	cluster_1
tcgggacactgtatactt	cluster_3
agacccatagcggcgaat	cluster_6
atacttgatcaattggat	cluster_1
aattggtatttctcggga	cluster_9
ccgtaacttgaaacccaa	cluster_6
cactgtacaaggcaggag	cluster_11
acaaggaaagaaaacagc	cluster_3
cgcataactgcagtccta	cluster_6
ctgtggacaaggaacagc	cluster_6
gccagattaagacataga	cluster_3
gtggtgctcaatttaaga	cluster_3
actgcaagcacggtccta	cluster_3
aattgggctcccctatta	cluster_1
gaaggggtacagatgaag	cluster_3
cttgaattcttggagctt	cluster_9
aagccaatagcgagatgt	cluster_1
ttaagaacggaccttacg	cluster_6
gcgcggcaccacccgtaa	cluster_3
cagactgccgttcggtcc	cluster_6
taagcttgctaatgtgta	cluster_3
taataggcttgttaagct	cluster_9
gtacagggacgatcatca	cluster_3
ttggatcctctaggacga	cluster_3
tgttcgcttacgcaggag	cluster_10
ctaggtcaagtcctaggt	cluster_3
gaaatagcttgtcagact	cluster_3
gcttgtacggactagagg	cluster_3
tcgcctaattggttaaga	cluster_4
caagtcaacagctaccga	cluster_3
tcgcctgaaatattggat	cluster_3
tggcagaacgtggtacag	cluster_3
cttacgctcaatgctgag	cluster_4
gaagggtcagtgatgaag	cluster_3
aacgtgcggcgtttcgca	cluster_6
cggcgtctaggtacaagg	cluster_3
aaagaagactcggtggtg	cluster_3
gtggtggagcttaccttc	cluster_3
agatgtacccaaggacga	cluster_6
tgcggttcgccttgctaa	cluster_3
agatgtgactcgccgtaa	cluster_3
cgttatgctgagcactgt	cluster_3
cgcatacctctaatactt	cluster_1
caagtcagacccagaccc	cluster_6
cagactattagtctgtgg	cluster_7
caagtcatagcggccaga	cluster_4
taagctagaccctcgcct	cluster_4
gggatctgctaaaacagc	cluster_4
atccggtgttcgggtgct	cluster_7
cctctagaggccatactt	cluster_4
acaagggaggccacccaa	cluster_4
atactttatttcatatac	cluster_4
agacccggtagggtttca	cluster_4
atatacgggatcgccaga	cluster_4
atacttggtgctggccat	cluster_7
acaaggcgcatacaagtc	cluster_11
atatacatatacgatcaa	cluster_4
taataggccagactcaat	cluster_4
caagtcgtggtggtcggc	cluster_10
agcacggcgcggatactt	cluster_4
gggatctaccgaccgtaa	cluster_4
ggattggactcgcaagtc	cluster_7
atgaagtcagtggttaac	cluster_4
atccggggtaggctaggt	cluster_4
cttacgctaggtcggtcc	cluster_3
atactttcagtgggtgct	cluster_4
caagtcaggttacgcata	cluster_4
cactgtcagactgtggtg	cluster_5
ccgtaaattagtcttgaa	cluster_4
ccgatggagctttgagac	cluster_4
cttgaaccgtaatgcggt	cluster_6
aggttatatttctctagc	cluster_4
ccacgcgactcggactcg	cluster_11
tctagctatttccctcta	cluster_4
atgaaggttaacctatta	cluster_3
ctaggtgctcccatagcg	cluster_3
acaagggttaacgcgaat	cluster_7
gccgtttggcagggtagg	cluster_7
ctgtggcgaaaggcgaat	cluster_5
taatagttcttgatactt	cluster_4
gtacagctgtggccgtaa	cluster_6
aacgtgttaagagagtga	cluster_6
tgctaaagtctgttcgca	cluster_4
ccgtaatgctaataagct	cluster_4
cgagcatctagctaccga	cluster_4
tttgggtcagtgggattg	cluster_4
atgaaggtcctagaaggg	cluster_7
caccacgctgagcgaaag	cluster_4
taccgaggacgattaaga	cluster_4
tcagtgctcaatccgatg	cluster_6
gtttcacctctagtggtg	cluster_6
tcagtgtcgcctgctgag	cluster_4
tttgggcactgttccaag	cluster_4
aggttaattagtgtcggc	cluster_4
ccacgcaacagctgctaa	cluster_4
ggacgacctctatggcag	cluster_4
tagaggagacccaacagc	cluster_6
tggcaggggatctgagac	cluster_4
ggacgagcgaataggtta	cluster_6
attagtaacgtgagtaaa	cluster_4
gctgagaattgggtcggc	cluster_10
ggtaggccacgccgcata	cluster_10
ttaagagctccccgagca	cluster_4
cttgaacgaaagttcttg	cluster_6
ggattgaggttacggtcc	cluster_4
gctccctgagacttgctc	cluster_6
gaaggggagctttaagct	cluster_3
ttcgcatgagacacaagg	cluster_7
ttcgcattggatgactcg	cluster_6
gatcaaacccaaccgatg	cluster_11
atgaaggatcaagaggcc	cluster_3
cggcgtcaaccgaccttc	cluster_11
atatacgctcccgctccc	cluster_5
tgcggtcaggagagtaaa	cluster_6
gccgttgtcggccggtcc	cluster_6
ctaggttatttctgtgta	cluster_6
tgagactgaattgagtga	cluster_6
aacgtgtgagactggcag	cluster_6
agatgtcggcgtcggtcc	cluster_4
cggtccttgctcgactcg	cluster_6
gcgcggtagaggttcttg	cluster_5
ccgtaacttgaagaaggg	cluster_6
agcacgcgaaagggtgct	cluster_6
cgagcaattagtgctccc	cluster_4
gaaggggagctttgagac	cluster_6
agtctgggacgagttaac	cluster_6
ttgctcacccaatatttc	cluster_4
cttacgacccaaaaagaa	cluster_5
gctgagagtaaagagtga	cluster_5
gtggtgagatgtggacga	cluster_6
ctaggtagacccgaaata	cluster_5
ttcgcatcgggaatatac	cluster_4
tctagcgccagattcgca	cluster_5
gccgttcaggagcgagca	cluster_5
aacagctcgggagagctt	cluster_6
gtacagggtgctggacga	cluster_6
gagcttgtcggcggacga	cluster_5
ggtgcttgtgtatgttcg	cluster_6
ctaggtgagtgataccga	cluster_5
cactgtgactcgaattgg	cluster_6
ctcaatagtctgttcttg	cluster_6
tttggggaagggaattgg	cluster_5
atgaaggccagagcgcgg	cluster_6
tgaattcatagacaggag	cluster_6
accttcctattaaccttc	cluster_6
ccgtaattcttgggattg	cluster_6
atgaagcctctaatgaag	cluster_6
cgcatagtttcatcagtg	cluster_6
gactcggtcctacgttat	cluster_5
gatcaagcgaatgaaggg	cluster_6
aattggggtgcttgcggt	cluster_6
gctcccgactcgtgaatt	cluster_5
gcgaatagcacggcgaat	cluster_6
gaggccaacgtgccgtaa	cluster_6
actgcagaagggggattg	cluster_6
ccgatgcgaaagaacgtg	cluster_6
acccaagagtgaacccaa	cluster_6
caagtcatccggccgtaa	cluster_6
catagaagtctgagtctg	cluster_6
cagacttggcagaccttc	cluster_11
atatacaacgtgtgcggt	cluster_5
tcatcactgtggagcacg	cluster_5
tttgggggccatgaaggg	cluster_6
gaggccttggatgctccc	cluster_5
aaagaaatccggggattg	cluster_6
ctcaatatagcgaccttc	cluster_6
actgcagatcaaatgaag	cluster_5
gactcgaccttccgttat	cluster_4
tgaattttgctccttacg	cluster_6
gagcttcaaccggttaac	cluster_6
gagtgaagcacgcggcgt	cluster_1
atagcgactgcagtacag	cluster_6
gcgcggccgatgtccaag	cluster_5
ttgctcgaagggctaggt	cluster_5
caggaggttaactgaatt	cluster_5
ggacgacaaccggtcggc	cluster_6
gaaggggagtgacaagtc	cluster_1
ttggattttgggttggat	cluster_5
tgaattcctctaagcacg	cluster_6
taccgaagtaaataatag	cluster_6
ctcaatacccaacttacg	cluster_11
gcgaatgtcctagctccc	cluster_5
ttcgcatgttcgtatttc	cluster_11
agcacgacaaggacggac	cluster_5
atataccaagtctccaag	cluster_5
acccaacagactcgcata	cluster_5
atccgggggatcgaaata	cluster_6
gtacagtaataggctccc	cluster_5
gcgcggcaagtcaccttc	cluster_7
atataccggcgtccacgc	cluster_6
cggtccacggacgtcggc	cluster_6
caggaggtcctatttggg	cluster_6
tgaattagatgtgcgcgg	cluster_6
tgtgtacagactacaagg	cluster_6
ttaagagagctttcagtg	cluster_4
agcacgtgctaagcgaat	cluster_6
gccagacagactttcgca	cluster_6
tgagacatagcgtttggg	cluster_4
aagccataataggaggcc	cluster_6
tcgggatgctaaatagcg	cluster_6
atgaagtctagcatatac	cluster_6
accttcatactttaccga	cluster_7
ggtgcttatttcgactcg	cluster_6
aggttatatttcgagctt	cluster_6
gctgagtgagacggtagg	cluster_6
agatgtttaagataatag	cluster_5
ttgctcaccttcttaaga1	cluster_6
ccgatgtaccgatccaag	cluster_6
tcgccttgtgtaacggac	cluster_6
ttgctcattagtgagctt	cluster_5
aattggtcagtgatccgg	cluster_7
tcagtgcactgttcatca	cluster_3
actgcacaaccgggacga	cluster_6
tcagtgcgaaagaacgtg	cluster_6
gactcgctattagtttca	cluster_5
ttaagaagtctgcttgaa	cluster_6
gatcaaagtctgggattg	cluster_5
ctaggtggtaggcagact	cluster_6
gccgtttgttcggagtga	cluster_6
caagtcccacgcatatac	cluster_6
ggacgagagctttaccga	cluster_5
gcgcggacggacttaaga	cluster_4
cgcatagaagggctgtgg	cluster_6
atataccttacgttaaga	cluster_5
cagactattagttctagc	cluster_5
gactcgtgttcgcataga	cluster_6
gtacagctgtggatactt	cluster_6
aggttattaagacaaccg	cluster_6
cagactagacccacccaa	cluster_6
cgttatcgcatatcagtg	cluster_6
ccgatgatataccctcta	cluster_5
taagcttgcggttcggga	cluster_6
ttcttggatcaattggat	cluster_11
ggtagggcgaatgctgag	cluster_6
gatcaaactgcaaaagaa	cluster_6
gtttcaaacagcgccgtt	cluster_5
gaaatatcgcctaattgg	cluster_5
aggttattaagatgttcg	cluster_6
ttcttgattagttctagc	cluster_5
agtaaatgctaaggtagg	cluster_6
tcagtggaaatatcggga	cluster_6
tcgcctagacccatactt	cluster_6
taatagtaagctttcttg	cluster_6
ttggatcgaaaggagctt	cluster_6
tgttcgaattgggccgtt	cluster_6
tcgggattcttgctatta	cluster_5
gcgaataacagccaccac	cluster_6
attagtatgaagtggcag	cluster_6
atgaagttgctcagtaaa	cluster_4
aaagaaagaccccactgt	cluster_6
tggcagattagtgatcaa	cluster_5
actgcaacccaattggat	cluster_5
gctccctccaagggacga	cluster_6
gcttgtatccggtcatca	cluster_5
tatttccctctaagtctg	cluster_1
atatacgactcgtgagac	cluster_6
acggaccggtccgtggtg	cluster_5
ggtaggcgcatacaagtc	cluster_11
aacagcgcgcgggggatc	cluster_6
ctattattggattgtgta	cluster_1
ctaggtaacagcggtagg	cluster_6
tgagaccgagcacgttat	cluster_1
gtacagggacgaagatgt	cluster_5
caccacgaggcccttacg	cluster_6
gagtgatcatcagactcg	cluster_5
agatgtgccgttggtagg	cluster_5
ggccatagatgttgtgta	cluster_4
ctaggtggtaggcaaccg	cluster_6
attagttcgcctttcttg	cluster_6
gccgttcaaccgcgcata	cluster_6
gactcggcgcggacaagg	cluster_1
caccacttgctcaattgg	cluster_5
cttacgagtctggctgag	cluster_6
ttgctcttcgcaaccttc	cluster_5
atccgggcgaatatgaag	cluster_4
cgttattaccgaatatac	cluster_5
tggcagagtctgtccaag	cluster_4
agatgtccacgctgctaa	cluster_6
ccgtaacttgaactgtgg	cluster_11
gtacagggacgaacaagg	cluster_5
taatagatagcgtgctaa	cluster_1
gactcgtgtgtaaggtta	cluster_6
gaaatacgaaagccgatg	cluster_6
ttggatgcgcggtgtgta	cluster_6
aaagaacgttatcgaaag	cluster_6
gagtgacaggagtctagc	cluster_6
tgcggtaccttcccgatg	cluster_7
ggattgggattgcctcta	cluster_5
ggtgcttcagtgtcatca	cluster_6
gcgaatggccatcggtcc	cluster_6
tagagggccgttacaagg	cluster_11
gtcctaggacgaggacga	cluster_6
ggattgccgatgtaagct	cluster_5
ggattgaaagaacactgt	cluster_4
gatcaaaattgggtcggc	cluster_4
gagcttcggcgttctagc	cluster_6
gagcttcaggagatccgg	cluster_4
agacccgagcttcaggag	cluster_11
tcgcctcggtccccacgc	cluster_11
aagccagtacaggtacag	cluster_3
tgtgtaatacttgcgcgg	cluster_1
ggtagggcttgtgaggcc	cluster_11
gaggccttcgcagagtga	cluster_6
agatgtgctccctagagg	cluster_5
tatttctagagggccgtt	cluster_6
gtggtggccgtttgctaa	cluster_6
tctagctaagctctcaat	cluster_5
gctcccctattatcatca	cluster_11
gcgaatctaggtctcaat	cluster_6
gcttgtccacgcgtccta	cluster_1
agacccggtgctctcaat	cluster_6
gtcggcgaagggtgctaa	cluster_11
aattggtcatcagggatc	cluster_11
taagctcaccacgactcg	cluster_1
tctagcaagccagccgtt	cluster_1
tttgggaattggcggcgt	cluster_1
cggcgtgaaataggattg	cluster_1
ttcttgacccaaggtagg	cluster_10
atagcgccacgcgctgag	cluster_1
tggcagaccttcagaccc	cluster_1
tgttcgtgaattggacga	cluster_1
gctccctttgggtctagc	cluster_1
gtacagtgaattgtggtg	cluster_1
caaccgggccattcgcct	cluster_1
cttacgggccatggtgct	cluster_2
cgcatacaggagcaggag	cluster_9
gcttgtaagtatagaccc	cluster_1
aaagaaggtaggttgctc	cluster_2
aagccacgaaagcgaaag	cluster_1
atatacgagcttcgaaag	cluster_1
gccgttatagcgaattgg	cluster_1
cgcatacatagatctagc	cluster_1
cttacgcttgaaatgaag	cluster_1
caggaggttaacagtaaa	cluster_1
atataccttgaagactcg	cluster_1
agacccattagtatatac	cluster_1
acggaccctctataatag	cluster_1
acggactaagctgggatc	cluster_2
tagaggctcaatcataga	cluster_1
cgttatgagcttgactcg	cluster_1
cttgaacaagtcgtttca	cluster_1
acggacccacgcattagt	cluster_1
accttcaaagaaggtagg	cluster_10
aattggcttgaagagtga	cluster_1
ctattatgtgtaggtgct	cluster_1
cgcatagagctttgttcg	cluster_1
tgagactcagtgcgcata	cluster_1
taagcttatttcacccaa	cluster_9
gctcccaacgtgcggcgt	cluster_1
gtacagtcagtggggatc	cluster_1
gctgagacccaagaggcc	cluster_1
tgagaccaaccggtccta	cluster_10
ctcaatacaaggattagt	cluster_9
ctattagtacaggcttgt	cluster_1
gcttgttatttccaggag	cluster_1
tgaatttggcagctaggt	cluster_1
aacagcgagcttttggat	cluster_1
gctcccagaccctcatca	cluster_10
tcgggataagctgtttca	cluster_1
gccgttgttaacagtaaa	cluster_1
ccgatggtcggccttacg	cluster_10
ggtagggctgagagcacg	cluster_10
gtacagggccatcataga	cluster_1
gcgaatccgtaagtggtg	cluster_1
gcttgtgctgagggacga	cluster_1
gttaactccaagctgtgg	cluster_1
tcatcaggattgcaccac	cluster_1
caccacgactcgtttggg	cluster_9
gtacagtaagctcctcta	cluster_2
tcagtgtagaggcttgaa	cluster_9
gaaggggtcggcgcttgt	cluster_9
tcagtgatactttcatca	cluster_2
ccgatgcagacttgctaa	cluster_1
agtctgcttacgcaggag	cluster_1
accttcggattgttggat	cluster_1
tggcagagtctgcgagca	cluster_1
gtttcacgagcaagaccc	cluster_1
gttaactgaattccgtaa	cluster_1
cggcgtaattgggtttca	cluster_1
ttgctccaggagctcaat	cluster_9
aacagccgaaagtcggga	cluster_1
gaaatacttacggttaac	cluster_1
aaagaaaggttatgctaa	cluster_1
cttacgaacagcattagt	cluster_1
ttcttgtgagacgactcg	cluster_2
cggcgtcaaccgcctcta	cluster_1
tgagacaccttcgctccc	cluster_1
cttacgttcttgaccttc	cluster_1
acaagggtttcaggtagg	cluster_2
ccgatgatagcggcgcgg	cluster_1
atacttggccatgatcaa	cluster_1
ggtaggtaatagtaagct	cluster_1
ttggattcgcctgcgaat	cluster_1
gggatcactgcaacggac	cluster_9
cgaaagggattgcctcta	cluster_1
tttgggaacgtgccacgc	cluster_1
gctgaggactcgccgatg	cluster_2
ctgtggcaagtcggtgct	cluster_1
gcgaatacccaagagtga	cluster_1
ttcgcaagatgtatagcg	cluster_2
ctcaattgctaagtttca	cluster_1
cgaaaggccgttggtagg	cluster_10
aacagccaggagcgttat	cluster_2
accttcctcaatttggat	cluster_1
ctattattcgcaaacagc	cluster_1
tccaagtgcggtttcttg	cluster_1
gccgttagtaaaatgaag	cluster_1
agcacgccgtaatcggga	cluster_2
agtctgtagaggcggtcc	cluster_1
gtacagcatagactgtgg	cluster_1
tttggggtttcatcagtg	cluster_1
agcacgcaaccgacaagg	cluster_1
agacccgaagggattagt	cluster_1
gctcccatacttatccgg	cluster_1
tttggggccagattggat	cluster_1
caggagacggacaaagaa	cluster_1
atccggctaggtaaagaa	cluster_10
gccgttatactttatttc	cluster_1
cgttatctcaataggtta	cluster_2
tgttcgtaatagtaagct	cluster_1
ctgtggggacgaacccaa	cluster_1
atgaagcagactacggac	cluster_1
cgagcaaggttacaaccg	cluster_1
atatacgagtgatagagg	cluster_1
gtcggctgcggtacccaa	cluster_10
tgctaactaggtatccgg	cluster_1
aacgtggtcggcaagcca	cluster_9
tctagcatgaagccgatg	cluster_2
accttcgccgttcataga	cluster_1
tgcggtccacgcggccat	cluster_1
aacgtggtcggctcagtg	cluster_1
atgaagacccaactatta	cluster_1
agatgtggtaggcctcta	cluster_1
cactgtaggttaaccttc	cluster_1
atccggtcgccttagagg	cluster_1
agatgtattagttaagct	cluster_1
caggagcgaaagaacagc	cluster_2
cgcataatagcgccgatg	cluster_1
acggacatatacgaaggg	cluster_1
acaaggctattatccaag	cluster_1
ttggatttcttggcgaat	cluster_1
ttaagatgcggtcgttat	cluster_1
tctagcccgtaactcaat	cluster_1
aacgtgttcgcagggatc	cluster_1
attagtgctgaggactcg	cluster_1
attagtcactgtcaggag	cluster_10
gaaataggacgattggat	cluster_1
agtaaagccgttaacagc	cluster_1
atatacgttaaccagact	cluster_1
tcgggaaccttcattagt	cluster_1
gcgcggatacttctaggt	cluster_1
gccgttgactcgggtgct	cluster_1
cttgaagagcttcactgt	cluster_1
gtttcacttgaacttacg	cluster_1
taataggcgcgggaaggg	cluster_1
gaggccatacttagtaaa	cluster_1
acccaagcttgttatttc	cluster_1
gttaactggcagccacgc	cluster_1
cggcgtgaggcctgttcg	cluster_1
tccaagtcagtgcgcata	cluster_10
ctcaattaatagaccttc	cluster_10
gagtgagggatctgcggt	cluster_1
tctagctaagctcgagca	cluster_1
atccggtgagacaagtat	cluster_10
caccacgtttcaatagcg	cluster_1
ttggattcagtgaagcca	cluster_1
accttctccaagcagact	cluster_1
gagtgattcttgagatgt	cluster_6
tatttcagtctgaagtat	cluster_1
agaccccaccaccgagca	cluster_1
taagctgcgaataacagc	cluster_1
atagcgagcacgtaccga	cluster_9
taagcttgtgtacgaaag	cluster_10
gctgagacggacctcaat	cluster_1
ctattagccgttgccaga	cluster_11
cttacgtaagctttgctc	cluster_1
cgagcagcgaatgagtga	cluster_2
attagttgagaccggcgt	cluster_1
gatcaacgttatcttgaa	cluster_1
tgcggtatgaagtgcggt	cluster_9
ctcaatgtcggcaccttc	cluster_1
aaagaaggacgacggtcc	cluster_7
tcgcctgctccccggtcc	cluster_7
caaccggccgttggccat	cluster_7
aagtattcgggagccgtt	cluster_7
cctctacgagcacaaccg	cluster_7
gtggtggtggtgggacga	cluster_4
cgaaagtgttcgacggac	cluster_7
cgcatacaggagatccgg	cluster_10
gactcgttgctcccgtaa	cluster_1
gagtgattggattccaag	cluster_7
gaggccgactcgccgtaa	cluster_7
ggacgatcgcctggattg	cluster_7
aagtattgaattaagcca	cluster_7
ccacgcggattgtggcag	cluster_1
gcttgtaccttcgaggcc	cluster_7
gcgaatccacgcgaggcc	cluster_7
tgtgtacaggagctgtgg	cluster_7
ttcgcagttaacattagt	cluster_7
cctctattaagacgaaag	cluster_1
caagtctaagctgaaggg	cluster_7
attagtccacgctgagac	cluster_7
tgttcgtggcagattagt	cluster_4
tttgggtggcaggaggcc	cluster_7
cactgtgactcgcaggag	cluster_1
gtttcaaggttaatactt	cluster_7
agtaaaaagccacttgaa	cluster_7
aagtattcagtgctgtgg	cluster_7
ctattaccgatggtccta	cluster_4
tcagtgtcgggaagtctg	cluster_7
ccacgccttacgtcagtg	cluster_4
taatagagcacggttaac	cluster_10
taagctcaccacgttaac	cluster_1
cgcatatgaattatatac	cluster_4
caagtcgaagggggacga	cluster_10
gaagggttggattgagac	cluster_4
gcttgtcaggagcctcta	cluster_10
acaaggaagtatgctgag	cluster_7
atacttatacttcaaccg	cluster_4
atagcgtcagtgaagtat	cluster_7
ggattgttaagagttaac	cluster_7
cttacgattagtgctccc	cluster_1
gttaactctagctgtgta	cluster_10
tcagtgtaataggtacag	cluster_7
gaggccagtctgggtgct	cluster_7
agcacgatacttgactcg	cluster_1
acaagggagctttggcag	cluster_7
cctctaaccttcgagctt	cluster_7
attagtagatgttggcag	cluster_1
aattgggtcctaagtctg	cluster_1
aacagcctgtggtgagac	cluster_7
ccgtaagaaataatatac	cluster_1
gaaatacgaaagtccaag	cluster_4
tagaggatccggtgcggt	cluster_1
ggtgcttagaggtatttc	cluster_1
cgagcaccgtaaggtgct	cluster_4
acggacttgctccggtcc	cluster_7
cggtccaagtatatgaag	cluster_10
gtcctactaggtcctcta	cluster_4
gtttcaagatgtacaagg	cluster_1
caccacttcgcaatgaag	cluster_10
caggagggattgcggcgt	cluster_6
cgaaagtgagaccataga	cluster_7
tgctaataccgatcgcct	cluster_6
atatacctcaatcgaaag	cluster_1
aacgtgggattgcttgaa	cluster_10
gaggcctgttcgtagagg	cluster_10
gtcggcgtcggcgatcaa	cluster_1
ggacgagctgagagtaaa	cluster_1
atataccaggagtgctaa	cluster_7
cggtccgcgcggggccat	cluster_1
agaccctgagacctatta	cluster_1
gactcggagcttaagcca	cluster_6
tttgggacccaacaagtc	cluster_10
ttaagacgagcacggcgt	cluster_1
agcacgacccaaaagcca	cluster_6
agtaaagactcgctgtgg	cluster_7
ttgctcccgtaaagtctg	cluster_6
attagttagaggaaagaa	cluster_1
aacagcagatgttttggg	cluster_6
ttgctccactgtgcgaat	cluster_4
ctcaatgggatcaggtta	cluster_6
cgttatatccggaattgg	cluster_1
gatcaagcgaatcaggag	cluster_4
tgcggtattagtcggcgt	cluster_1
cactgtgctcccgccgtt	cluster_6
tgctaatttgggctaggt	cluster_1
cagactgtggtgagtaaa	cluster_6
gtggtggttaacggacga	cluster_10
atatacgctgagaattgg	cluster_6
agtaaaacccaatgcggt	cluster_10
acccaaccgtaagtttca	cluster_11
gcttgttgcggtcaaccg	cluster_7
tcgggacggcgtcggtcc	cluster_6
gccgttccgatggtttca	cluster_1
atccggacaagggccaga	cluster_7
acggaccgcataccacgc	cluster_1
tcatcagtcggcaacgtg	cluster_1
attagtcggcgttaatag	cluster_1
gtcctaggtgctacccaa	cluster_1
ccacgcatacttgagctt	cluster_1
atataccgagcatcgcct	cluster_1
tttgggtatttcgtcggc	cluster_1
cctctagtcggctcagtg	cluster_1
acggaccttgaactaggt	cluster_6
gactcgttcttgccgtaa	cluster_1
cctctagcgcggctgtgg	cluster_11
ggtgcttctagctgagac	cluster_1
ttggatgaagggcttgaa	cluster_1
acggacctcaatatgaag	cluster_4
ttcttggactcgtctagc	cluster_1
gatcaaggacgacggtcc	cluster_7
ttaagagcgcggtccaag	cluster_1
cagactttggattaagct	cluster_1
aacgtgttgctcaagcca	cluster_1
aggttagcgaatgactcg	cluster_2
cttgaacgaaagggtagg	cluster_7
taatagtgagactaagct	cluster_7
atatacaccttcagtctg	cluster_7
acccaattggatcagact	cluster_2
gagcttcgttatggattg	cluster_7
agtctgccacgcaattgg	cluster_1
gagctttccaagcataga	cluster_10
agacccgtcctaccacgc	cluster_1
atagcggctgagggattg	cluster_2
gcgcggaaagaatccaag	cluster_1
attagtcaaccggaaggg	cluster_1
gggatcggccatctgtgg	cluster_1
agatgtctcaatggacga	cluster_2
gctgagcaaccgtaccga	cluster_2
ctcaatttcttgtaccga	cluster_2
cgttatgccgttagtaaa	cluster_7
ccgatgatccggtcgcct	cluster_7
aagccatcgcctgtcggc	cluster_4
ggtgcttagagggatcaa	cluster_7
taatagatataccggcgt	cluster_1
cttgaatgaattaagcca	cluster_1
ctattatgctaattcgca	cluster_9
cgagcaagatgtgagctt	cluster_1
taatagtgcggtttgctc	cluster_4
gtcggccagactccgatg	cluster_1
catagacgaaagtttggg	cluster_10
atagcgttggattcggga	cluster_1
accttcaccttctcagtg	cluster_2
agtaaaccgatggtacag	cluster_1
cgttatatagcggccgtt	cluster_4
atatacgccagaccacgc	cluster_7
tccaagagcacgattagt	cluster_7
tcgcctttggatcaggag	cluster_1
aagccaacggacacggac	cluster_1
tcgcctgaaggggggatc	cluster_1
aacgtgtgctaactcaat	cluster_2
ctattaattagttgctaa	cluster_4
cagactaggttatctagc	cluster_2
gccgttttggatttcgca	cluster_1
cgttattaatagctcaat	cluster_1
ggacgatggcagtaagct	cluster_9
gtttcaatagcgagtaaa	cluster_7
gtacagattagtgccgtt	cluster_1
cagacttgaattacaagg	cluster_4
aaagaatagagggtttca	cluster_1
gagctttcgggagctgag	cluster_1
accttcgaaggggaaata	cluster_7
tcagtggactcgctaggt	cluster_2
acggactgctaatatttc	cluster_7
ttgctcagtctgtatttc	cluster_2
gatcaagtacagagatgt	cluster_7
tcatcagctgagttcgca	cluster_1
atgaagaaagaatggcag	cluster_10
accttccaggagggccat	cluster_9
cactgtgaagggagatgt	cluster_2
cactgtctaggtggccat	cluster_1
tgttcggatcaataccga	cluster_2
taccgaagacccaacagc	cluster_1
tccaagccgatgcgaaag	cluster_2
gtcggcattagtaccttc	cluster_1
ggacgaatccggtcagtg	cluster_1
actgcaatagcgtcgcct	cluster_1
tggcagcgagcagggatc	cluster_1
acccaactattattcttg	cluster_4
atacttatagcgacggac	cluster_1
ggccattcatcacgagca	cluster_1
tgctaattaagagctccc	cluster_2
aagtatcttgaagctgag	cluster_2
cgcatagaaataacaagg	cluster_1
gaggcccttacgctgtgg	cluster_1
cgttatattagtaccttc1	cluster_1
atccggttgctcatatac	cluster_1
gccgttgcgcggaattgg	cluster_1
gtttcatcagtgagcacg	cluster_1
ttaagatgctaagaaata	cluster_1
gcttgtcactgtctgtgg	cluster_7
gaaggggagtgatgctaa	cluster_1
ggccatggacgatccaag	cluster_1
agacccgtttcagcgcgg	cluster_1
acccaatgttcgcttacg	cluster_1
cttgaaagtctgtgttcg	cluster_1
ggtaggttcttggaggcc	cluster_4
accttcaacagccgcata	cluster_7
gtacaggccagaccgtaa	cluster_1
ttaagacaagtcgagctt	cluster_6
catagaagtaaagagctt	cluster_6
ccgatgttcttgaagtat	cluster_4
cggtcccttgaacgagca	cluster_1
ttcttgcaagtcccacgc	cluster_4
ctattattcgcattcgca	cluster_1
aacagcccacgctaagct	cluster_5
acccaaaaagaacttacg	cluster_4
taagctagtctgcaccac	cluster_1
agtctgtgtgtaggtagg	cluster_1
aaagaagagcttatccgg	cluster_1
gactcgtgctaacataga	cluster_1
taatagtgcggtgcgaat	cluster_1
cggtccagatgtcggcgt	cluster_1
gtacaggaaataagtctg	cluster_11
tggcagcaagtccaagtc	cluster_1
acaaggcaaccgttcgca	cluster_1
gtggtggtacaggcgaat	cluster_2
cactgttatttccaaccg	cluster_1
agacccagacccagcacg	cluster_1
tcagtgccacgcatccgg	cluster_1
cgcatagagtgaattagt	cluster_1
gtttcactaggtagtaaa	cluster_2
ctattatcgggagcgaat	cluster_1
aacagcttaagaagtctg	cluster_1
tgctaacaaccgagaccc	cluster_1
ttaagaacaaggctgtgg	cluster_1
atagcgccgatgccgtaa	cluster_1
agtctggcgcggcgaaag	cluster_6
atgaagcctctaacccaa	cluster_6
cgagcaaagtatttgctc	cluster_1
agtctgactgcagttaac	cluster_1
gaggcctgagacgcgcgg	cluster_1
gactcgtcatcaagatgt	cluster_9
ctaggtaacagcaattgg	cluster_1
ggacgaatatacagcacg	cluster_10
atatacagatgttcatca	cluster_9
cttacgtaccgatgcggt	cluster_9
atagcgatacttgtacag	cluster_1
ggccatgggatcagtctg	cluster_1
gactcggaggccttcttg	cluster_9
ctaggtcaaccggctccc	cluster_9
actgcaaacagctgaatt	cluster_1
cgcatagactcgcaaccg	cluster_1
aattgggcttgtgccgtt	cluster_9
tcagtgctcaatggccat	cluster_4
gtcctatggcagatgaag	cluster_1
atagcgtgctaaccacgc	cluster_4
tccaagtctagctagagg	cluster_9
gctgagatgaagatagcg	cluster_1
tttggggtttcattcgca	cluster_9
aagtatctcaatgtttca	cluster_1
atatactttgggttcgca	cluster_9
cttgaatgcggtcggtcc	cluster_4
gaggccaagtataggtta	cluster_1
atccggtccaagtaagct	cluster_1
atagcgttcgcacttacg	cluster_1
cttgaatctagcaattgg	cluster_9
ccgtaattgctcaacgtg	cluster_1
ttggatcgttatcgttat	cluster_1
cggtcctaagctgtacag	cluster_1
atgaagtcgcctatccgg	cluster_9
aagtattaagctcagact	cluster_1
gctcccaccttcccgatg	cluster_7
gaaataaccttcccgatg	cluster_4
gctgagaagtatgtccta	cluster_7
ctattaatatactaagct	cluster_1
ctgtgggcgcggtatttc	cluster_1
ccgtaataagctactgca	cluster_2
cttgaatggcagtgctaa	cluster_4
atgaagatagcgaagcca	cluster_1
cttacgaacgtgtctagc	cluster_1
gcgaatattagtcgcata	cluster_1
gaggccattagtaggtta	cluster_1
cttgaagagcttagtaaa	cluster_1
taatagatatacgcgaat	cluster_1
acccaatgctaatcggga	cluster_9
agtctgaggttagtggtg	cluster_1
tgaattttcgcatccaag	cluster_4
tgtgtatagagggtttca	cluster_9
gatcaaactgcatcatca	cluster_1
gtttcataccgagccaga	cluster_8
atatactgtgtaactgca	cluster_9
ccgtaaagatgttaccga	cluster_7
ccgatgtggcaggagtga	cluster_9
aagtatgctcccggtagg	cluster_8
tgtgtaaggttaattagt	cluster_6
ctaggttgtgtaagtaaa	cluster_1
ggtaggatccgggggatc	cluster_9
ttcgcaacggacgaggcc	cluster_1
caagtctgagacgtccta	cluster_1
ccgtaacgaaagcggcgt	cluster_2
atatacatacttgctccc	cluster_7
gaagggttcttggcttgt	cluster_9
tgaattaccttcgtacag	cluster_9
gctcccggtagggaggcc	cluster_11
catagatgttcgctgtgg	cluster_1
atacttcatagatggcag	cluster_1
ggtgctagatgttagagg	cluster_1
cggtcctgttcggaggcc	cluster_11
gggatctcatcatagagg	cluster_9
aattggcggtccgtttca	cluster_9
gatcaatgagaccgcata	cluster_11
gctcccgaagggtgttcg	cluster_9
cggcgtctattagttaac	cluster_10
ttggatgtacagttggat	cluster_9
ggtgctaagtatatactt	cluster_1
ctgtggtaccgaatatac	cluster_9
gtcctaacccaatcagtg	cluster_9
aaagaagccagaggattg	cluster_11
gaaataaattggggattg	cluster_9
gactcggctcccgcgaat	cluster_4
gagtgaggtagggtacag	cluster_1
atagcgtgttcgtagagg	cluster_1
gatcaagcgcgggccaga	cluster_11
ctcaattttggggccaga	cluster_5
cgttatatgaagccgatg	cluster_8
gagctttaccgacataga	cluster_10
agaccccaaccgcagact	cluster_9
agcacgcagactaagcca	cluster_4
taagctttgctcaacgtg	cluster_11
cagactcaagtcaccttc	cluster_1
gaggccaagccactgtgg	cluster_1
ggtgctggccatgttaac	cluster_6
cgcataacccaacaccac	cluster_7
tggcaggcgcgggtccta	cluster_11
ctgtggtaagctccgatg	cluster_1
accttctcgggacgaaag	cluster_1
ccacgctgaattccacgc	cluster_9
cggcgtgtttcactgtgg	cluster_9
tgtgtacgagcagcttgt	cluster_2
gtcctatgagaccagact	cluster_4
ctgtggattagtatatac	cluster_1
gcgcggattagtgccgtt	cluster_9
taataggaggccaagtat	cluster_2
agtaaaatgaagtcgcct	cluster_8
aacgtgggacgacagact	cluster_4
ttggattaatagagatgt	cluster_4
aacagcgagtgacctcta	cluster_10
tttgggcaggagggtgct	cluster_1
gatcaaaagtattagagg	cluster_9
ttcgcacaagtcccacgc	cluster_1
gcgaatcagactcaccac	cluster_11
gactcgatccggagtaaa	cluster_7
cggtccaggttagttaac	cluster_11
caggagggtagggggatc	cluster_1
ccgtaaagaccctgcggt	cluster_1
ggtgctgccagagtcggc	cluster_6
aacgtgaccttcgatcaa	cluster_6
agcacggccgttcgcata	cluster_6
atacttggattgaagtat	cluster_1
ctattaagcacggggatc	cluster_1
ttcgcacactgtctatta	cluster_9
atacttcaagtcttcgca	cluster_1
caaccgtgcggtatccgg	cluster_11
gctccccaccaccagact	cluster_1
ctcaataacgtggttaac	cluster_8
gtggtgcggcgtgaaata	cluster_1
cgcataagtaaaatactt	cluster_6
tctagcgttaacttcgca	cluster_11
tagaggttcgcagctccc	cluster_11
cgagcagagtgagccaga	cluster_1
gtcctactattataccga	cluster_9
atagcgcgttatgttaac	cluster_1
caaccgggattgaccttc	cluster_10
tagaggctgtgggggatc	cluster_1
acggacatacttaacgtg	cluster_11
tcgcctgactcgttaaga	cluster_10
tagaggatgaagcaccac	cluster_1
caagtcatagcggaaggg	cluster_11
gggatcggtgctttcttg	cluster_9
ccgtaatcagtgtcggga	cluster_1
ctcaatgaagggcaccac	cluster_1
cagactggattgatatac	cluster_2
tcgggacgcatagactcg	cluster_9
tccaagagtaaaaaagaa	cluster_6
caaccgctattacagact	cluster_1
tcagtgtgcggtttgctc	cluster_1
gagtgaggacgatgctaa	cluster_10
aaagaaattagtatatac	cluster_4
aacgtgttaagagccaga	cluster_9
tcatcacaagtccttgaa	cluster_1
ttcgcagctgaggatcaa	cluster_4
atacttttgctcgtttca	cluster_9
atagcggtttcaaaagaa	cluster_11
aagtatgtcggctcatca	cluster_9
gatcaatatttctccaag	cluster_1
gaggcccggtccggacga	cluster_1
ctcaatatgaaggcgcgg	cluster_1
tcgggaagatgtcagact	cluster_8
tggcaggcgaatcgaaag	cluster_1
atagcgaagccattggat	cluster_4
ccgtaatagaggtaagct	cluster_4
agtaaagagcttaattgg	cluster_11
gggatctcgggacaaccg	cluster_1
agcacggtcctaaggtta	cluster_6
gcttgtcgagcaggacga	cluster_7
cgcatagactcgactgca	cluster_9
atccgggcgaatcttacg	cluster_1
caccaccggcgtatatac	cluster_1
aagccatgcggtcaccac	cluster_1
acggaccaaccgggccat	cluster_6
cgttatgttaacggattg	cluster_1
gtacagcatagattcgca	cluster_11
gccgttcgagcagactcg	cluster_1
tgagacgtcggcttcgca	cluster_1
tagaggaaagaaagatgt	cluster_1
gttaacgcgaatcttgaa	cluster_9
gcgaatttggatgcgaat	cluster_1
gtttcaacggaccggcgt	cluster_1
tccaagagtctgcataga	cluster_1
tttgggattagttgaatt	cluster_9
tcgggacttgaacggtcc	cluster_11
gaagggcaggagaagcca	cluster_1
tggcagtgaattgggatc	cluster_1
gagtgacgaaagagtaaa	cluster_11
agatgtatagcggccgtt	cluster_6
aaagaaacggacttggat	cluster_9
cttacgggccatgagctt	cluster_1
aaagaaaagtatttaaga	cluster_1
aagccaccgtaatcagtg	cluster_1
cgagcaggtagggagctt	cluster_10
gaaggggccgtttctagc	cluster_1
ccgatggttaaccggtcc	cluster_1
catagagaaatatgagac	cluster_11
atagcgtggcagcttacg	cluster_1
tagagggtttcacctcta	cluster_1
gcgaatggtgcttctagc	cluster_6
caccacccgatgattagt	cluster_11
cctctacggtcctagagg	cluster_7
tgaatttggcagtccaag	cluster_4
ggtaggcaagtcttcttg	cluster_6
aattgggactcgaaagaa	cluster_1
ttaagagctccctttggg	cluster_11
tcatcatcatcagtacag	cluster_1
cgaaagcaaccgtcgcct	cluster_1
cagacttgcggtgggatc	cluster_1
cgcatatttggggatcaa	cluster_6
ttcttgcaagtcacggac	cluster_8
aaagaaagtaaagagtga	cluster_1
caccacaggttaaggtta	cluster_1
agcacgagtctgcgaaag	cluster_6
gttaacccgatgcaaccg	cluster_1
ttcttggtcggcagaccc	cluster_1
gagtgagaggccgaaata	cluster_1
gctgagagtctgctatta	cluster_4
aattggctgtggctatta	cluster_1
ggattgtatttccgcata	cluster_1
tttgggttcttgcgttat	cluster_2
ccgtaattcttgaacgtg	cluster_1
ggacgattaagatgaatt	cluster_1
gccgttactgcagtggtg	cluster_1
cctctaactgcaaaagaa	cluster_1
cgagcaatgaagtctagc	cluster_1
aagccaccgatgtaatag	cluster_11
caccacttgctccgaaag	cluster_1
tgaattttggatttcttg	cluster_1
tagaggcactgtggtgct	cluster_9
ggattgtgcggttcatca	cluster_4
caggagttcttggccgtt	cluster_9
cgaaaggtcggcaacagc	cluster_1
ccgtaagcgaatgttaac	cluster_1
gccgttaacgtgtgctaa	cluster_11
ggtgctggccatgactcg	cluster_1
gtcggcatagcgaagtat	cluster_1
atgaaggtttcagggatc	cluster_2
agacccggacgagtacag	cluster_1
cgaaagccacgcgggatc	cluster_1
ctgtggggattgctcaat	cluster_1
gggatcagcacgcctcta	cluster_1
ggattggtttcaacggac	cluster_6
ttaagagtcggcgaggcc	cluster_11
ctattacagactgtggtg	cluster_11
tgaattgctcccgggatc	cluster_4
ctattagcttgtggtagg	cluster_1
aattggcactgtgtacag	cluster_1
ctcaataagtataattgg	cluster_1
catagattcgcagatcaa	cluster_1
gtcctacaggaggagctt	cluster_1
gctgaggaaatagccaga	cluster_7
tggcagtgttcgcttacg	cluster_7
ttggataagtattttggg	cluster_7
aacgtgttcgcactcaat	cluster_4
gcttgtgctgagagtaaa	cluster_7
ggacgaccacgcccgatg	cluster_7
aagtatcggcgttcatca	cluster_7
ctcaatttgctcgcgcgg	cluster_7
ccgatgcggtccattagt	cluster_7
tggcagtggcagctgtgg	cluster_1
ccgtaaaaagaagagtga	cluster_1
agtctgctattaagatgt	cluster_7
atacttcatagaacggac	cluster_7
tcgcctcatagaagtaaa	cluster_7
atacttggccatgcgaat	cluster_6
tgttcgagacccaagcca	cluster_7
gatcaaaccttcgccaga	cluster_7
aggttacgcatagttaac	cluster_7
ccacgctctagctatttc	cluster_1
cctctagcgcggaccttc	cluster_7
atgaagggtgctgactcg	cluster_7
ggattgaaagaataccga	cluster_4
atatactgagactctagc	cluster_7
cttgaagactcgagtaaa	cluster_7
cggcgtggacgacagact	cluster_4
aacagcggtaggcggcgt	cluster_7
aggttagccgttggacga	cluster_1
cactgtgtcctaggccat	cluster_7
cgagcacaagtccaccac	cluster_7
cgcatattgctcgtcggc	cluster_7
ttcttgagtctggtcggc	cluster_7
tgcggtcggcgtatccgg	cluster_1
ttaagaccgtaagctccc	cluster_7
cgttattagaggaggtta	cluster_7
cttacgctattatgaatt	cluster_7
tcagtgaattggcttgaa	cluster_7
ctcaataagccataccga	cluster_7
gttaacaccttccataga	cluster_7
tgagacatatacgaaata	cluster_4
gggatcacaaggcataga	cluster_7
tttgggttaagacagact	cluster_4
cgagcaccacgcctgtgg	cluster_7
tgaattggtaggcactgt	cluster_7
tgagacgtacagtgcggt	cluster_7
gccgttgaggcctcagtg	cluster_7
tagagggaaggggctccc	cluster_7
tcgccttgcggtaacgtg	cluster_11
gttaacacccaaagcacg	cluster_7
actgcagaaatacagact	cluster_7
caagtccgaaagggtgct	cluster_7
ccgatgtgtgtaagtaaa	cluster_1
tcgggagcgcggcttacg	cluster_4
ttcgcagcgaatcgaaag	cluster_4
aaagaacaggagcttacg	cluster_7
gtttcagtttcaccgatg	cluster_11
ccacgctgaattcctcta	cluster_7
caccacgtttcatgctaa	cluster_1
caccacgcgcgggaggcc	cluster_1
ctattaaggttagagctt	cluster_7
gagtgaaccttccggcgt	cluster_10
gccgttgtttcatgagac	cluster_11
cgaaaggactcgggtagg	cluster_1
atatacgatcaacgttat	cluster_7
cactgtggattgggattg	cluster_7
gagtgaggacgacggcgt	cluster_7
cgagcacctctatgagac	cluster_4
actgcaagcacgaggtta	cluster_7
cttacgatccggcactgt	cluster_7
aggttacactgttcggga	cluster_4
atatacccgatggtcggc	cluster_2
gctcccggacgatgaatt	cluster_11
ctattaccgatgggattg	cluster_4
tcgggaaattggttcgca	cluster_7
tcagtggcttgtgaaata	cluster_11
ggattgtcgcctcaagtc	cluster_4
tccaagttcgcaaagcca	cluster_6
ggtgctatatacccacgc	cluster_7
tgaattcttgaagaaggg	cluster_7
tagaggagtctggactcg	cluster_7
cagactgatcaagttaac	cluster_7
cagactactgcagatcaa	cluster_7
tgaattaagtatgaaggg	cluster_11
gggatcacggaccaagtc	cluster_1
attagtggacgagaggcc	cluster_7
gtttcactgtgggttaac	cluster_7
ggtagggtacagtgtgta	cluster_5
tgctaataagctcaaccg	cluster_7
aggttatgagaccgttat	cluster_7
gaagggtcatcacctcta	cluster_6
gaagggacaagggtccta	cluster_11
ttaagaatacttgagtga	cluster_7
ggccatacccaaggtgct	cluster_7
ctcaatgtacagtaagct	cluster_7
gatcaagttaactcggga	cluster_6
gcgaatacaaggatgaag	cluster_7
aattggcactgtgtacag1	cluster_5
attagttatttcgcgcgg	cluster_11
tgagacgaaggggtcggc	cluster_7
tatttctgttcgatagcg	cluster_7
tatttcgcgaatatatac	cluster_1
atccggtaccgaggacga	cluster_6
aattggagatgtccgatg	cluster_7
ggattgaaagaaagatgt	cluster_6
caggagtcgggacgagca	cluster_7
gatcaaccacgctccaag	cluster_1
tttggggactcggtccta	cluster_10
actgcaactgcattggat	cluster_6
tgttcgaaagaatctagc	cluster_11
cgagcatgagactcagtg	cluster_7
ttggataattgggttaac	cluster_6
taagctttcttgttcttg	cluster_11
cggtccggacgagtttca	cluster_7
tgaattaccttcagtaaa	cluster_7
ttaagaaagccattcgca	cluster_6
agtaaacctctacctcta	cluster_7
caccaccggcgtcgaaag	cluster_6
tggcagcctctatatttc	cluster_7
tgttcggatcaacaaccg	cluster_7
gagtgatccaagaagcca	cluster_6
ggtagggagtgacttgaa	cluster_6
gggatcatacttacaagg	cluster_4
acaaggcagacttgcggt	cluster_6
gaaatacgttatgtccta	cluster_7
cactgtccacgctccaag	cluster_6
gtacagttaagatgaatt	cluster_4
caccacaaagaagaaggg	cluster_6
caccacggccatatatac	cluster_11
ggtagggttaacaaagaa	cluster_6
taagctaacagcgccaga	cluster_7
caccacgatcaaaggtta	cluster_7
agcacgtgaattaacgtg	cluster_6
cggcgtgaagggatactt	cluster_4
attagttgcggtcagact	cluster_7
ttggatgtttcattgctc	cluster_10
ggacgaacccaagcgcgg	cluster_6
gtcggccgttatctgtgg	cluster_6
gctgaggagcttatccgg	cluster_6
atatactcgcctggtgct	cluster_1
tttgggtgtgtacagact	cluster_6
gttaacatgaagaattgg	cluster_6
atatacgagtgaatagcg	cluster_6
tgaatttgctaagtcggc	cluster_6
aattgggccgttccacgc	cluster_6
atagcgcaccacaaagaa	cluster_6
acaaggttaagaacccaa	cluster_1
ttgctctcgggacaccac	cluster_11
ggtagggccgtttcagtg	cluster_1
atgaagaagccataagct	cluster_6
atatactgcggttaccga	cluster_7
cttacgcgcataagtaaa	cluster_6
gagctttttgggagtaaa	cluster_10
ttggattgagacgaaggg	cluster_6
atgaagatccggactgca	cluster_6
gagtgatgaattgtcggc	cluster_5
aaagaatatttctcggga	cluster_11
ccgatggcgcggatccgg	cluster_11
agatgtgaaatatctagc	cluster_6
cctctagagcttcaccac	cluster_6
accttccactgtaattgg	cluster_7
ctgtggattagtatactt	cluster_4
ttaagaatagcgggacga	cluster_4
gccgttggacgactcaat	cluster_6
accttcgtggtgaagcca	cluster_6
tcatcaaggttaattagt	cluster_6
tgttcgcttgaacgagca	cluster_1
acaaggttcgcatcatca	cluster_6
gagcttcttgaaatccgg	cluster_6
ctcaatcatagaaagcca	cluster_6
cttacgaacagcaaagaa	cluster_6
taataggatcaacttacg	cluster_5
tggcagcggcgtaaagaa	cluster_6
gcgaattcgggacagact	cluster_4
agacccggacgagaaggg	cluster_7
aagccagcgaataccttc	cluster_6
ctcaatgccgtttaccga	cluster_11
cttacgatatacttggat	cluster_6
cggcgttgttcgagatgt	cluster_6
caaccgtgagactgctaa	cluster_6
taagctccgtaacaccac	cluster_6
tgtgtaacccaataatag	cluster_7
aacgtgccgatgactgca	cluster_6
atagcgcaagtctggcag	cluster_11
caccacttcttggagctt	cluster_6
acaagggtacagtcagtg	cluster_6
tgaattgagtgaagtaaa	cluster_6
caccacccacgccagact	cluster_6
actgcaacaaggttggat	cluster_11
caagtcccgtaatgaatt	cluster_11
ctgtggtaatagcactgt	cluster_7
aacgtgtggcagctcaat	cluster_4
gaggccgctccccgcata	cluster_1
cttgaagagtgaaattgg	cluster_7
aacagcttaagatgaatt	cluster_4
atatactgagacttcttg	cluster_6
tgctaatgtgtacagact	cluster_6
agtctgtgcggtgggatc	cluster_6
tcgcctagcacgatccgg	cluster_5
acccaaggacgagagctt	cluster_6
cggtccggattggaaggg	cluster_6
tccaagcgaaagcagact	cluster_6
accttcatatacctatta	cluster_6
atccggtgtgtaaacagc	cluster_7
ctcaattcagtgccacgc	cluster_10
tggcagagatgttcagtg	cluster_6
tcagtggtcggccgagca	cluster_11
ggtgctatatacaggtta	cluster_1
gagcttcctctaccgtaa	cluster_6
ttggatcttgaaaagtat	cluster_6
tcatcaggccatggccat	cluster_6
gtggtgatacttcaaccg	cluster_1
ctattagtcggctaatag	cluster_7
agtctgacggaccactgt	cluster_6
cggtcccatagattaaga	cluster_6
ctcaataattggactgca	cluster_7
gggatctagaggtgctaa	cluster_7
cctctaggacgagactcg	cluster_6
cagactggtgctatactt	cluster_1
caagtctcatcagcttgt	cluster_6
gtggtgctgtgggactcg	cluster_6
aacgtgcaccacacaagg	cluster_6
taccgacgagcaagatgt	cluster_5
ccgatggagcttgtacag	cluster_7
tagaggcagactaagcca	cluster_7
gcgcggtgtgtaaccttc	cluster_6
ctcaatttcttggcgcgg	cluster_7
cgttatgcgcggattagt	cluster_6
tagaggagatgtattagt	cluster_6
taagcttgagaccgttat	cluster_6
aagtatagatgtgagtga	cluster_6
gcgaatgctccctatttc	cluster_11
agtaaaaccttcccgtaa	cluster_6
ccgatgcgcatatgcggt	cluster_7
ggtgctggtgcttgagac	cluster_6
atagcgtaatagttggat	cluster_7
atatacgcttgttccaag	cluster_7
ttcttgttgctcgccgtt	cluster_6
aagtatcggtcctttggg	cluster_1
tccaaggagtgacgaaag	cluster_11
caccaccgttatacaagg	cluster_6
ctaggtacggacggacga	cluster_7
gaaataatacttaggtta	cluster_6
gaaatatgtgtacgcata	cluster_6
caccactgcggttagagg	cluster_11
ccgatgatccggggacga	cluster_6
taccgaaacgtggctccc	cluster_6
ccgtaaaaagaacaaccg	cluster_6
cctctaactgcatctagc	cluster_10
gatcaagactcgggccat	cluster_6
gccagaaacgtggcgcgg	cluster_1
tttggggatcaaagatgt	cluster_6
cttgaatcatcattcgca	cluster_5
tgttcgctattatcgcct	cluster_6
cggtcctaccgagtccta	cluster_6
acccaagtggtgaattgg	cluster_7
cggtcctgagactagagg	cluster_6
gagcttcaagtcgttaac	cluster_6
gaaatagtcggcggtgct	cluster_7
ctcaatttaagattggat	cluster_10
tgctaaacaaggcggtcc1	cluster_6
aattgggctgagaagcca	cluster_6
tttgggacccaatgctaa	cluster_6
cttgaagttaactgttcg	cluster_6
taccgagccagaactgca	cluster_7
ttggatggtgctcgcata	cluster_10
gctcccgtcctagctgag	cluster_7
acccaagtacagaacgtg	cluster_6
ccgatggcgaattttggg	cluster_7
tgaattacggactaatag	cluster_6
agtctgcgcatagcgcgg	cluster_6
cttacggatcaagccaga	cluster_11
cgcatattcttggtcggc	cluster_7
caagtctgcggtgactcg	cluster_7
ggacgacaagtccaagtc	cluster_6
catagagcgaatatactt	cluster_5
gcttgtcgaaagcctcta	cluster_6
tatttctcgggaatatac	cluster_6
ggtaggtagaggtccaag	cluster_7
tccaagtggcagcctcta	cluster_6
ggattgaagtatttcttg	cluster_1
cggtccttcgcatggcag	cluster_7
taagctggtaggtgttcg	cluster_7
ctaggtagtaaatatttc	cluster_11
taagctatacttggtgct	cluster_6
gccgttagtctgtgctaa	cluster_6
cctctaccgatgttaaga	cluster_10
gccgttctaggtcttacg	cluster_7
tgtgtatcatcacaccac	cluster_6
cgcatacaaccgtctagc	cluster_1
aagtattaccgatagagg	cluster_11
caagtcggtaggcctcta	cluster_11
gttaaccgaaagactgca	cluster_1
agatgttaccgaagtaaa	cluster_6
cgcataatgaaggagctt	cluster_7
atacttcactgttccaag	cluster_7
gaagggagatgttagagg	cluster_6
atgaaggcgaatgagtga	cluster_1
ctgtggaaagaaggtagg	cluster_6
cggcgtgtttcaacggac	cluster_1
gaaataggattggctccc	cluster_1
cgaaagggacgattcgca	cluster_6
taccgaatatacctcaat	cluster_8
cctctagactcgacccaa	cluster_1
aaagaacaaccgcactgt	cluster_1
tgttcgttcttggccgtt	cluster_1
actgcatttgggtggcag	cluster_7
cgttattgagacgagtga	cluster_4
tccaagattagttagagg	cluster_7
tttgggcggcgtgactcg	cluster_1
taagcttgtgtataagct	cluster_7
cgagcatcagtgcggcgt	cluster_7
gaggccaaagaagactcg	cluster_11
